ああ	嗚呼
あい	愛
あい	相
あいあんないと	赤鉄騎士
あいあんぶりーど	鉄血の子供
あいあんぶりーど	鉄血の子供たち
あいおい	相老
あいが	相賀
あいぐん	璦琿
あいけいびょういん	愛慶病院
あいこ	愛子
あいこと	相異
あいことば	合言葉
あいこん	眼魂
あいこんじま	眼魂島
あいさつ	挨拶
あいすくいーん	氷の女王
あいすどらごんぞく	氷竜族
あいすまん	冷凍男
あいすめいでん	氷の乙女
あいぜんてっこう	愛染鉄工
あいぜんどらぐーん	鉄竜騎兵団
あいぜんりったー	鉄騎隊
あいだ	間
あいつ	彼
あいつ	男友達
あいづはん	会津藩
あいて	相手
あいど	愛奴
あいどる	人気者
あいのしゅく	間の宿
あいのぼ	相昇
あいば	饗場
あいひき	相率
あいぼーるこれくたー	眼球蒐集家
あいま	相俟
あいもの	合物
あいり	藍里
あいろ	隘路
あうるむがーでん	黄金の園
あえ	阿閇
あえんてっぱん	亜鉛鉄板
あえんとてっぱん	亜鉛鍍鉄板
あお	仰
あお	扇
あお	群青
あお	蒼
あお	阿保
あおい	葵
あおい	青井
あおいたつまき	蒼い竜巻
あおいはなのせいれい	青い花の精霊
あおうみ	青海
あおがね	蒼金
あおきこういち	青木光一
あおしま	青島
あおしま	青嶋
あおそ	青苧
あおた	青田
あおぬま	青沼
あおぬまこおり	青沼郡
あおのせいてん	蒼の聖典
あおのでぃーゔぁ	蒼の歌姫
あおば	青羽
あおばえ	蒼蝿
あおひ	青引
あおやぎかい	青柳会
あか	緋
あか	赫光
あか	赭
あか	閼伽
あかいいなずま	紅い稲妻
あかいかめんのおとこ	赤い仮面の男
あかいけ	赤池
あかいこ	赤猪子
あかいすぺーど	赤いスペード
あかぎ	赤城
あかさか	赤坂
あかし	証
あかしたつひこ	赤司竜彦
あかしっくれこーど	禁忌教典
あかじだ	赤耳朶
あかぢ	赤地
あかつき	暁
あかつき	曉
あかつきがん	暁銃
あかでみーしょう	アカデミー賞
あかなめ	垢嘗
あかねたか	茜鷹
あかねぶり	垢舐
あかば	赤羽
あかびら	赤平
あかふくごおり	あかふく氷
あかまなこ	赫眼
あかむかで	朱ムカデ
あかもく	赤目
あかもんどおり	赤門通
あかり	灯火
あかんまちどおり	赤間町通り
あが	上
あがた	県
あがたもり	県守
あがたもりのふち	県守淵
あがりやま	東山
あがるみっく	恵与
あがるみっく	恵与的
あき	秋
あき	精
あきこ	明子
あきご	秋蚕
あきしの	秋篠
あきしまし	昭島市
あきたか	昭孝
あきち	空地
あきつかい	蜻蛉会
あきつしま	蜻蛉島
あきつみかみ	現御神
あきなり	昭登
あきのり	昭則
あきのり	章憲
あきひと	明仁
あきひとへいか	明仁陛下
あきもと	秋本
あきやま	秋山
あきやまのしたひおとこ	秋山之下氷壮夫
あきら	明羅
あきら	昿
あきら	章
あきらか	明
あきらのみや	明宮
あぎ	阿伎
あぎとげんしゅ	顎門原種
あぎょう	阿形
あくあ	水冠
あくいん	悪胤
あくえりあす	水域
あくしすぴらー	中枢塔
あくたがわしょう	芥川賞
あくどうじ	悪童子
あくね	英祢
あくま	彼女
あくま	阿久魔
あくまげんすい	悪魔元帥
あくまぞく	悪魔族
あくまどうじん	悪魔道人
あくまばら	悪魔祓
あくまひゃくれっくすけん	悪魔百烈恐竜拳
あくまりき	アクマ力
あぐいがわ	阿久比川
あぐん	鴉軍
あけ	暁
あけびはら	山女原
あけんばら	山女原
あげかえし	揚返
あげかえしこうじょう	揚返工場
あげし	上石
あげひばり	揚雲雀
あこ	明子
あこうま	赤馬
あこおうじじんじゃ	悪王子神社
あこまる	阿古丸
あこめ	袙
あご	顎
あごあしつき	顎足付き
あごあしまくらつき	顎足枕付き
あごう	阿号
あさか	浅香
あさぎり	朝霧
あさぎわし	浅葱鷲
あさぐも	朝雲
あさげ	朝餉
あさこ	麻子
あさごはん	朝御飯
あさしん	暗殺者
あさだ	浅田
あさひまち	朝日町
あさみ	麻美
あさめし	朝飯
あざ	字
あざしょうみょう	字小名
あざな	字
あざり	阿闇梨
あしおと	足音
あしか	海驢
あしかがばくふ	足利幕府
あしかがよう	足利様
あしかせ	足枷
あしがるがさ	足軽笠
あしがわ	芦川
あしげんしゅ	足原種
あしこく	芦国
あした	朝
あした	未来
あしつうら	葦津浦
あしはら	葦原
あしゅらおう	阿修羅王
あしょろがわ	足寄川
あじあ	亜細亜
あじやしゅう	亜細亜洲
あじょん	代理人
あじろあみ	網代編
あじろがさ	網代笠
あじわい	味
あすか	明日香
あすか	飛鳥
あすけがわ	足助川
あすてりずむのかいてん	アステリズムの廻転
あすむ	明日夢
あすわがわ	足羽川
あずきあらい	小豆洗い
あずさ	梓
あずま	吾妻
あずま	東
あずまうた	東歌
あずまざか	東阪
あずまみや	東宮
あぜくら	校倉
あそざんなげ	阿蘇山投げ
あそゆるっとはく	阿蘇ゆるっと博号
あた	与
あた	中
あた	当
あた	當
あたい	直
あたいうじ	直氏
あたか	恰
あたまあわせかさ	頭合わせ笠
あたわ	能
あだ	仇
あだ	寇
あだう	仇討
あだなし	雔
あだびと	徒人
あだむへっど	聖断罪
あぢか	足近
あぢしきたかひこねのかみ	阿遅志貴高日子根神
あっかんべん	悪漢鞭
あっせん	斡旋
あっぱしおなーと	激情的に
あっぴがわ	安比川
あつ	篤
あつ	集
あつお	敦生
あつがりや	暑がりや
あつき	篤輝
あつこ	篤子
あつまれ	集合
あつもの	羹
あつりょくがま	圧力釜
あつれき	軋轢
あづか	関
あづちまち	安土町
あづま	吾妻
あてぃあ	阿媂娅
あてがね	当金
あてびと	貴人
あでのしんさんりんさん	アデノシン三リン酸
あと	痕
あとざらし	後晒
あとり	花鶏
あどがわ	安曇川
あなが	強
あなさこたに	穴迫谷
あなさこだに	穴迫谷
あなざーでんおう	アナザー電王
あなすはじめ	穴巣始
あなた	宇宙
あなど	穴門
あなにひみ	阿那爾比弥
あなほのみこ	穴穂御子
あなほのみや	穴穂宮
あなーきー	無政府
あに	豈
あにま	意思
あねじま	姉島
あのくたらさんみゃくさんぼだい	阿耨多羅三藐三菩提
あはせて	合
あば	網場
あばたろうきわみ	暴太郎極
あばれごま	暴れ独楽
あひした	相親
あひだ	間
あびのかしはら	阿備柏原
あふぎ	扇
あふさか	逢坂
あふりか	阿弗利加
あぶ	襾部
あぶえ	虻江
あぶでんみそ	油伝味噌
あぶみがわ	鐙革
あぶらさかふなはし	油阪船橋
あぶらつ	油津
あぶらつきなめりばんとう	油坏滑蛮刀
あぶらめまんぷく	脂目マンプク
あぶらや	油屋
あぶらやまかんこうどうろ	油山観光道路
あぶるまがわ	破間川
あぷれんてぃす	見習い徒弟
あべにゅ	並木道
あぼしさん	阿星山
あま	余
あま	天
あま	尼
あま	海人
あま	蜑
あま	阿麻
あまかぜ	天風
あまかわ	天川
あまがさ	雨笠
あまがさきじゅんさ	尼崎巡査
あまくさしろうときさだ	天草四郎時貞
あまくだり	天下り
あまくだり	雨降り
あますがわ	天増川
あまず	天水
あまぞねす	女傑
あまたけ	天獄
あまだな	天棚
あまちせんせい	天地先生
あまつくに	天国
あまつまら	天津麻羅
あまてらす	天照大御神
あまてらす	女神
あまてらすおおみかみ	天照大御神
あまにゅうどう	尼入道
あまぬの	亜麻布
あまね	普
あまの	天野
あまのかぜ	天の風
あまのがは	銀河
あまのがわ	銀河
あまのがわがくえんとし	天ノ川学園都市
あまのじんじゃ	天野神社
あまのぬなはらおきのまひとのすめらみこと	天渟中原瀛真人天皇
あまのはばきり	天羽々斬
あまのむらくものつるぎ	天叢雲剣
あまひこのみこと	天日子尊
あまびこにゅうどう	尼彦入道
あまみこくとうしょうちゅう	奄美黒糖焼酎
あまやま	雨山
あまり	余
あみがさ	編笠
あみこう	網高
あむし	阿無志
あめ	天
あめ	阿毎
あめ	飴
あめいじんぐ	亜雌異人愚
あめくにおしはるきひろにわのすめらみこと	天国押波流岐広庭天皇
あめくにおしはるきひろにわのすめらみこと	天国押波琉岐広庭天皇
あめつち	天地
あめのうずめのみこと	天宇受売命
あめのこやねのみこと	天児屋根命
あめのひほこ	天之日矛
あめのほひのかみ	天菩比神
あめのみなかぬしのかみ	天御中主神
あめのわかひこ	天若日子
あめみや	雨宮
あめりか	亜米利加
あめりかかくめい	アメリカ革命
あめりかがっしゅうこくのどくりつ	アメリカ合衆国の独立
あめりかどくりつかくめい	アメリカ独立革命
あめりかぶんがく	アメリカ文学
あめわかひこじんじゃ	天稚彦神社
あもん	阿門
あや	亜矢
あや	危
あや	彩
あや	文
あや	絢
あやいがさ	綾藺笠
あやか	彩香
あやかし	綾香市
あやかし	鬼惑
あやかじのね	彩風の音
あやかほし	妖奇星
あやがさ	綾笠
あやつりにんぎょう	西洋操人形
あやま	誤
あやまちりょう	過料
あやまり	失
あやみ	彩美
あやめ	菖蒲
あやゐかさ	綾藺笠
あゆすし	鮎鮓
あゆちがた	年魚市方
あゆちがた	年魚市潟
あゆみ	進歩
あら	見
あら	露
あら	非
あら	顕
あらえだんち	荒江団地
あらおい	新生
あらかつま	阿羅羯磨
あらかわ	新川
あらかわ	荒川
あらき	荒木
あらくれむてきじょう	荒くれ無敵城
あらくれもの	荒くれ者
あらごと	荒事
あらごも	荒菰
あらた	新
あらた	荒田
あらちえき	愛発駅
あらは	效
あらま	荒増
あらやしきえんぎ	阿頼耶識縁起
あらやしきのしるし	アラヤシキの徴
あららぎ	阿良良伎
あらりえき	粗利益
あらりえき	荒利益
あらりりつ	粗利率
あられ	霰
あらわ	著
あらわ	露
あらわ	顕
あり	在
あり	有
ありあけのかた	有明の方
ありがた	難有
ありきた	有北
ありさま	有様
ありはら	在原
ありはらぐち	在原口
ありみち	在通
ありん	阿璘
ありーんれいきゃくき	アリーン冷却器
ある	或
あるい	乍
あるい	或
あるかいっくすまいる	仏像の微笑
あるかなむ	神の力
あるじ	主
あるでばらん	神盟騎士団
あるひと	或人
あれ	阿禮
あれくす	荒楠
あれぢ	荒地
あれてー	徳
あわき	淡木
あわぎ	阿波伎
あわじ	安治
あわじまち	淡路町
あわせ	袷
あわづかんじゃ	粟津冠者
あわび	鮑
あわれ	愍
あわれ	憐
あをふち	青淵
あんき	暗記
あんぎす	蛇の使徒
あんぐわい	案外
あんげん	安元
あんこくきしがうざー	暗黒騎士ガウザー
あんこくきしぜくす	暗黒騎士ゼクス
あんこくきしぜむ	暗黒騎士ゼム
あんこくけんくらやみ	闇黒剣月闇
あんこくしょうはどう	暗黒掌波動
あんこくのしとがいるとん	暗黒の使徒ガイルトン
あんこくのよろい	暗黒の鎧
あんこくほう	暗黒咆
あんこーる	世界録
あんしょうばんごう	暗証番号
あんしよう	暗誦
あんじゃく	晏弱
あんじゅ	案主
あんじゅしと	晏孺子荼
あんじんしゃ	安神車
あんせむ	讃歌
あんぜん	安全
あんそりっと	突飛なるもの
あんたんだん	地方総監
あんだーさーきっと	地下廻路
あんちくしょう	安竹小
あんてぃーく	実弾兵器
あんてん	鞍点
あんでそん	安大成
あんとろほもるぴしす	安杜路卜木児畢思
あんどろめだざ	アンドロメダ座
あんどん	闇呑
あんな	安和
あんびりかりあ	石に耳あり
あんまく	暗幕
あんまはかせ	案摩博士
あんゆ	暗喩
あんらく	安樂
あんりゅう	安立
あーくとう	円弧灯
あーくるーじゅ	紅い聖櫃
あーすどらごんぞく	大地竜族
あーてぃふぁくと	古代遺物
あーむどしるばー	銀肢脚
あーむどひびき	装甲響鬼
あーむどぶらっく	黒肢脚
いあんふ	慰安婦
いい	逶迤
いいのや	井伊谷
いいひと	好いひと
いうきよう	遊興
いうくわく	遊廓
いうけい	有形
いうりよく	有力
いぇんじゅう	炎駒
いぇーがー	猟兵団
いえ	家
いえ	屋
いえど	雖
いえろーどらごんぞく	黄竜族
いおうざん	硫黄山
いおぎ	岩脇
いおし	五百禩
いか	医家
いか	厳
いか	如何
いかいりゅう	倚海竜
いかおりがみ	烏賊折神
いかがく	医科学
いかごりんだん	烏賊五輪弾
いかすみほう	烏賊墨砲
いかずち	雷
いかずちいあい	黄雷居合
いかずちいっそう	雷一掃
いかつおみ	雷大臣命
いかづち	雷
いかづち	雷霆
いかづちりゅう	迅雷流
いかでぃすく	烏賊ディスク
いかやりぶすま	烏賊槍ぶすま
いかり	伊刈
いかり	錨
いかる	怒る
いかれいとう	烏賊冷凍
いかん	云何
いかん	如何
いがい	意外
いがく	医学
いがさ	藺笠
いがさきにんじゅつどうじょう	伊賀崎忍術道場
いがせん	伊賀線
いがやくりすけ	伊賀谷栗助
いきおい	勢
いきだんち	壱岐団地
いきまつだい	生松台
いきもの	生き物
いきょ	依拠
いぎ	意義
いぎょう	異形
いぎょうてい	囲繞堤
いぎりすひがしいんどがいしゃ	イギリス東インド会社
いくぐひ	活杙神
いくこ	偉恭子
いくさ	戦
いくさがみ	戦神
いくど	幾度
いくばい	幾倍
いくばく	幾許
いくまつ	幾松
いくめいりびこいさちのみこと	伊久米伊理毘古伊佐知命
いぐさ	藺草
いけ	医家
いけがきしんたろう	生垣真太郎
いけじゅん	池純
いけずき	生食
いけたに	池谷
いけだ	池田
いけなみ	池波
いけのうえ	掖上
いけのうち	池之内
いけのうのみこと	池生命
いけんしんさせい	違憲審査制
いげたにかさ	井桁に笠
いご	囲碁
いさ	諫
いさい	畏斎
いさい	鷧齋
いさお	勇雄
いさか	伊坂
いさか	諍
いさぎよ	潔
いさにい	イサ兄
いさみあし	勇み足
いさをし	勲
いざ	伊邪
いざかはのみや	伊邪河宮
いざきししょ	伊崎支所
いざな	誘
いざなきのみこと	伊邪那岐命
いざなぎ	伊邪那岐
いざなみ	伊邪那美
いざなみのみこと	伊邪那美命
いざほわけのみこ	伊邪本若気王
いざほわけのみこと	伊邪本和氣命
いざよいきゅうえもん	十六夜九衛門
いざりがわ	漁川
いし	医士
いし	宝石
いしい	石井
いしおかだいいちはつでんしょ	石岡第一発電所
いしかり	石狩
いしかわしゅばるつごえもん	石川シュバルツ五右衛門
いしかわみきあき	石河幹明
いしきりみち	石切道
いしぐろ	石畦
いしこりどめのみこと	伊斯許理度売命
いしだ	石田
いしだいら	石平
いしついじ	石築地
いしの	石野
いしぶみ	碑
いしま	石島
いしょういっしんにんしゅりけん	衣装一新忍シュリケン
いしょく	委嘱
いしよくぢう	衣食住
いしらい	石占井
いしんこう	惟新公
いじかおいつめ	猪鹿追詰
いじゅく	異熟
いじんおうこう	懿仁王后
いすけ	伊助
いすけよりひめ	伊須気余理比売
いすず	五十鈴
いず	何
いずかた	何方
いずくん	安
いずこ	何処
いずはやおのみこと	出早雄命
いずみや	和泉屋
いずもいわい	出雲伊波比
いずもたける	出雲建
いせい	医生
いせいきゅう	韋斉休
いせんば	鋳銭場
いそ	磯
いそたけるのみこと	五十猛命
いそぢまりななとせ	五十七歳
いそぢまりふたとせ	五十二歳
いそぢまりむとせ	五十六歳
いそなか	石中
いその	磯野
いそのかみ	石上
いそのみや	磯宮
いそむら	磯村
いそや	磯谷
いそん	韡村
いた	甚
いた	至
いたくら	板倉
いだ	出
いだ	抱
いち	一
いち	市
いちい	櫟
いちいのつぼね	一位局
いちおう	一応
いちおくそうはくちか	一億総白痴化
いちく	市村
いちくいん	市来院
いちごう	一毫
いちざき	市崎
いちしょうやばんこく	一小野蛮国
いちしん	市神
いちじく	無花果
いちじょうそうしれい	一条総司令
いちにん	一人
いちの	市野
いちのさわ	一谷
いちのたに	一の谷
いちのの	市野々
いちのべのおしはのきみ	市辺之忍歯王
いちのむら	一ノ村
いちびと	市人
いちめ	市女
いちめがさ	市女笠
いちもんじがさ	一文字笠
いちもんじぷれす	一文字プレス
いちりつ	市立
いちりゅう	一柳
いちろう	一郎
いぢわる	意地惡
いっかくせいばゆにごるおん	一角聖馬ユニゴルオン
いっかくせんきん	一攫千金
いっかくどう	一攫洞
いっかんけんじょう	一貫献上
いっきゅうけん	一級剣
いっきょう	一矯
いっこく	一国
いっさん	一山
いっしにいみょうをつけこうかいせしはなし	一子に異名を付けて後悔せし話
いっしんでん	一身田
いっせい	一成
いっせいにんれつざん	一斉忍烈斬
いっそくひゃくそくへそのかみ	一束百束ヘソの守
いっだましい	生魂
いっとうりゅう	逸刀流
いっとごけん	一都五県
いっぴつそうじょう	一筆奏上
いっぺい	一平
いっぺきばんけい	一碧萬頃
いっぼう	一防
いっぽんばな	一本花
いつ	云
いつ	何時
いつ	鎰
いつき	斎
いつき	齋
いつしにいめうをつけこうくわいなす	一子異名ヲ付後悔成話
いつしにゐめうをつけてこうくわいせし	一子に異名を付けて後悔せし話
いつちよ	一丁
いつつ	五
いつついちめがさ	五つ市女笠
いつつよせたちばな	五つ寄せ橘
いつてん	一點
いつびしにほんじゅうこう	五菱日本重工
いつぶ	聿部
いつぽう	一法
いつまでん	以津真天
いつらく	逸樂
いづな	飯綱
いづはやお	出早雄
いづら	五浦
いで	出
いでがわ	井出川
いでこ	入鼓
いでみつおんがくしょう	出光音楽賞
いでんし	遺伝子
いでんじょうほう	遺伝情報
いと	孫
いとう	伊藤
いとう	伊透
いとうけんいつ	伊藤憲一
いとうこざえもん	伊藤小左衛門
いとしろ	石徹白
いとしろがわ	石徹白川
いとすぎとさくらのきょうそう	糸杉と桜の協奏
いとま	遑
いとよね	糸米
いどろ	維泥
いな	否
いないちょうたんかな	意内長短称
いなお	鋳直
いなおいがわ	稲生川
いなしひつなしこなしがなし	毋意毋必毋固毋我
いなずまれんどう	稲妻連動
いなばちょうどおり	因幡町通り
いなもとさん	稲本さん
いなりいちもん	イナリ一門
いにしえ	古
いにしえのごせいてんし	古の護星天使
いにしへ	往昔
いぬ	犬
いぬ	狗
いぬい	乾
いぬいろくろう	乾緑郎
いぬかい	犬飼
いぬきまとい	射貫まとい
いぬぶし	犬伏
いぬぼう	犬吠
いねわら	稲藁
いのう	伊奈冨
いのうえ	井上
いのち	生命
いのちのしずく	生命の酒
いのちろん	生命論
いのほり	亥の堀
いのりのうた	祈りの歌
いは	况
いは	斎
いはいのみや	斎宮
いはきろう	岩喜樓
いはつき	石坏
いはのひめ	石之日売
いはゆる	所謂
いはれ	伊波禮
いはれ	石寸
いばじょ	茨女
いひ	云
いひちろう	伊七郎
いび	萎靡
いびただし	揖斐憲
いふぁどん	梨花洞
いぶ	衣部
いぶ	韋部
いぶか	訝
いぶきちょうかん	伊吹長官
いぶくろげんしゅ	胃袋原種
いへ	家
いほりののみや	廬入野宮
いぼじょう	疣状
いま	今
いま	坐
いま	未
いま	現在
いまおがしらがわ	今尾頭川
いまし	汝
いましめのかぜ	戒めの風
いまじゅくかみのはる	今宿上ノ原
いまずみ	今泉
いまだ	今田
いまだんばし	今谷橋
いまだんやき	今谷焼
いまばし	今橋
いまよう	今様
いまーむ	指導者
いみ	忌
いみ	意味
いみいろ	忌色
いみずしとしょかん	射水市図書館
いみな	諱
いむらゔぁ	航海譚
いも	妹
いも	藷
いもい	斎
いもう	芋生
いもうと	義妹
いもうとじま	妹島
いもじ	鋳物師
いもちょう	芋長
いもっこ	妹っ子
いもろぎ	飯盛木
いや	厭
いやがわ	祖谷川
いやさか	弥栄
いやし	賤
いやしく	苟
いやしのかぜ	癒しの風
いやだか	弥高
いやちこ	灼然
いよいよ	弥弥
いよいよ	愈々
いらんかくめい	イラン革命
いり	圦
いりえ	入江
いりえすまじんぞく	イリエス魔人族
いりん	依玲
いるいかんそうき	衣類乾燥機
いるかざ	いるか座
いるぼん	日本
いれ	入
いろ	色
いろぢゃや	色茶屋
いろどり	彩
いろりなべ	囲炉裏鍋
いわ	云
いわ	曰
いわ	況
いわい	岩井
いわお	巌
いわかさ	岩笠
いわきりまなぶ	岩切學
いわくら	磐座
いわこんじょう	岩紺青
いわさき	岩崎
いわじま	岩島
いわとじま	岩戸島
いわながひめ	石長比売
いわべにしし	岩紅獅子
いわみごうつ	石見江津
いわらぐち	岩原口
いわれ	磐余
いわん	況
いん	銀
いん	院
いんえい	陰映
いんおんきょう	殷温嬌
いんが	陰我
いんきょ	允許
いんきょう	殷嶠
いんぎんぶれい	慇懃無礼
いんさつ	印刷
いんし	院試
いんじゅんこそく	因循姑息
いんじゆんこそく	因循姑息
いんせい	隠棲
いんせいんと	銀盤
いんぞ	因所
いんちき	銭
いんちゅあん	銀川
いんちゅうしゃれん	咽中炙臠
いんてぐらるりったいてれび	インテグラル立体テレビ
いんてりあすぺーすあや	インテリアスペース彩
いんでっくす	禁書目録
いんとん	隠遁
いんどうぼう	引導坊
いんのう	陰嚢
いんば	因幡
いんぱくと	衝撃
いんぱるすかんすう	インパルス関数
いんぷう	陰風
いんぺい	隠蔽
いんもん	陰門
いんゆ	隠喩
いんようふ	引用符
いゔぃるどらごん	悪竜
いーじす	盾の乙女
いーじすとらいがー	神盾撃器
うぃすかー	龍髭
うぃっち	妖婆
うぃっち	魔女
うぃんがーど	飛竜騎士
うぃんどどらごんぞく	風竜族
うぇいにゃん	偽娘
うぇいぼー	微博
うぇこむんど	虚圏
うぇすたりす	西国
うぇーかた	親方
うえ	上
うえき	上村
うえきもり	上村森
うえだ	上田
うえにんじぞうぼさつ	飢人地蔵菩薩
うえね	上家
うえはら	上原
うえはるのかみ	殖春神
うえばら	上原
うぉっか	火酒
うぉーそうとう	ウォー槍刀
うぉーたーどらごんぞく	水竜族
うぉーらいく	戦争妖精
うお	魚
うおずみ	魚住
うおのまち	魚町
うか	泛
うか	浮
うかいがわ	宇甘川
うかが	闚
うかやふきあへずのみこと	鵜葺草葺不合命
うかんがわ	有漢川
うがい	鵜飼
うがじんじゃ	宇賀神社
うがのみたまのみこと	宇賀魂命
うきぐも	浮雲
うきぶくろ	鰾
うきよ	浮世
うきよえ	浮世絵
うくらいなのえいゆうとし	ウクライナの英雄都市
うこさべん	右顧左眄
うこん	鬱金
うご	動
うさぎ	彼女
うさぎざ	うさぎ座
うさむら	ウサ村
うさん	胡散
うしおりがみ	牛折神
うしおわきあが	涌潮
うしじま	牛島
うしぞう	烏斯蔵
うしぞうこく	烏斯蔵国
うしでぃすく	牛ディスク
うしな	失
うしのみこと	大人命
うしやま	牛山
うしゅべつがわ	牛朱別川
うしろおばた	後小畑
うしろばま	うしろ浜
うしわかまる	牛若丸
うしわくまる	牛わく丸
うじ	宇治
うじ	氏
うじきんとき	宇治金時
うじな	氏名
うじひこ	莵道彦
うじむし	蛆蟲
うじゃ	宇蛇
うす	臼
うすい	烏須井
うすいえんどう	碓井豌豆
うすかげ	薄影
うすけし	宇須岸
うすゆき	薄雪
うすらい	薄氷
うずひこ	宇豆比古
うずまがわ	巴波川
うずら	鶉
うそうぜんじ	烏巣禅師
うた	歌
うた	譜
うた	転
うたがい	疑
うたごえほうそうぶぷろじぇくと	ウタゴエ放送部プロジェクト
うたしない	歌志内
うたすつ	歌棄
うたの	菟田野
うたのかみけ	雅楽頭家
うたひめ	歌姫
うたりじんじゃ	菟足神社
うたろう	宇太郎
うち	中
うちう	宇宙
うちだ	内田
うちのみたまどの	内御玉殿
うちはま	内浜
うちゅういみん	宇宙移民
うちゅうきのどっきんぐおよびけいりゅう	宇宙機のドッキングおよび係留
うちゅうぎじゅつかいはつきこう	宇宙技術開発機構
うちゅうくうかん	宇宙空間
うちゅうこうがく	宇宙工学
うちゅうしょくみん	宇宙植民
うちゅうじん	宇宙塵
うちゅうせいぶつがく	宇宙生物学
うちゅうそくど	宇宙速度
うちゅうななし	宇宙ナナシ
うちゅうのいんふれーしょん	宇宙のインフレーション
うちゅうのねんぴょう	宇宙の年表
うちゅうはんたー	宇宙狩人
うちゅうぼかんいんでべーだー	宇宙母艦インデベーダー
うちゅうやろうらいでん	宇宙野郎雷電
うちゅうりゅう	宇宙竜
うぢ	姓
うぢ	氏
うっかがー	金武大川
うっけつ	鬱血
うった	打田
うったい	鬱滞
うっとうおんせん	打当温泉
うっとうがわ	打当川
うつ	冩
うつ	打
うつ	遷
うつく	妍
うつく	美
うつくし	美麗
うつしよ	現世
うつしよ	顕界
うつせみまる	空蝉丸
うつつ	現界
うつの	内野
うつわ	器世間
うづき	卯月
うづも	埋
うづゑ	珍笑
うでげんしゅ	腕原種
うなず	首肯
うぬ	汝
うぬぼ	自惚
うね	釆
うねびりょうぼさんこうち	畝傍陵墓参考地
うねめ	采女
うはん	雲帆
うば	乳母
うば	姥
うばそく	優婆塞
うぶ	初心
うぶ	羽部
うぶ	雨部
うぶすながみ	産土神
うへ	上
うまおさ	馬長
うましあしかびひこじのかみ	宇麻志阿斯訶備比古遅神
うましじんじゃ	宇麻志神社
うましじんじゃ	馬子神社
うまのり	騎馬
うまや	厩
うみ	海
うみ	湖
うみ	滄溟
うみかな	思加那
うみがわ	宇美川
うみこぼうず	海小坊主
うみさちひこ	海幸彦
うみとぅくがに	思徳金
うみまちちゃちゃちゃ	海街チャチャチャ
うむいかじ	想い風
うめ	梅
うめざわ	梅沢
うめたお	埋殪
うめづる	梅鶴
うめのい	梅ノ井
うめのはな	梅の花
うめばち	梅鉢
うやむや	有耶無耶
うやんこー	高祖祭
うら	憾
うら	浦
うらうめ	裏梅
うらうめばち	裏梅鉢
うらおーだー	裏オーダー
うらけい	裏罫
うらこやま	宇良古山
うらしのびたいまぐみ	裏忍退魔組
うらじげんはくしゃくらでぃげ	裏次元伯爵ラディゲ
うらそうご	裏ソウゴ
うらべ	卜部
うらまさ	裏正
うらみ	怨
うらみ	裏見
うらみみじんじゃ	麗耳神社
うらめにゅー	裏メニュー
うらや	羨
うりあげそうりえき	売上総利益
うりあげだかえいぎょうりえきりつ	売上高営業利益率
うりうり	瓜売
うりさばき	売捌
うりりがわ	有利里川
うるとらそなー	超波動探知
うるとらみゅーじかる	超歌劇
うるふ	狼
うるわしのびゃっこ	麗しの白虎
うれ	恤
うれ	愁
うれひ	患
うろこ	鱗
うろぼろす	身喰らう蛇
うわぐすり	釉薬
うん	芸
うん	韵
うんかんこく	雲鬟国
うんぎょう	吽形
うんげんさいしき	繧繝彩色
うんぜん	温泉
うんたいけんしょう	雲梯顕聖
うんだい	雲岱
うんてい	雲梯
うんてん	運転
うんどう	運動
うんどうえねるぎー	運動エネルギー
うんどうりょう	運動量
うんぬん	云々
うんばん	雲版
うんぼうだいたく	雲夢大沢
えい	嬴
えい	映
えい	栄
えい	榮
えい	郢
えいあいりょうすーだん	英埃領スーダン
えいえいとう	鋭鋭刀
えいおう	衛王
えいか	穎果
えいか	穎花
えいがのときわすれ	栄花の秋忘れ
えいがん	永観
えいきゅう	永久
えいきゅうのひ	永久の灯
えいきゅうるーぷ	永久ループ
えいきょう	永享
えいぎょうりえき	営業利益
えいこう	曳航
えいこうきしろーぜ	影煌騎士狼是
えいこうまる	栄光丸
えいご	英語
えいしゅう	瀛洲
えいしゅん	英舜
えいしょう	永承
えいしょう	永正
えいじ	永治
えいじょく	栄辱
えいじろう	英二郎
えいすけ	栄助
えいせいこうはしゅりけん	鋭星光波手裏剣
えいそ	永祚
えいぞうしりょう	映像資料
えいだん	営団
えいだんちかてつ	営団地下鉄
えいちょう	永長
えいてい	英貞
えいとく	永徳
えいとげだん	鋭棘弾
えいにん	永仁
えいぶつか	詠物歌
えいほう	永保
えいまん	永万
えいやう	榮養
えいゆうあいこん	英雄眼魂
えいり	営利
えいりあんらぷそでぃー	異星人狂奏曲
えいりゃく	永暦
えいりん	嬰鱗
えいろく	永禄
えいわ	永和
えう	要
えうぽまてぃあか	エウポマティア科
えうろぱ	欧羅巴
えが	画
えがきて	描き手
えがた	得難
えがん	恵岸
えき	益
えきじんさい	疫神祭
えきぞちっく	異国趣味
えきちう	液中
えきちょう	駅長
えきまじん	役魔陣
えきり	疫痢
えくあどるきょうわこく	エクアドル共和国
えくせるしあ	冠絶の姫王
えくれーる	紫電
えぐぞだす	逃奏劇
えぐち	江口
えこ	依怙
えこだ	江古田
えこひいき	依怙贔屓
えこーちぇんばーか	エコーチェンバー化
えこーちぇんばーこうか	エコーチェンバー効果
えじき	壊色
えすかとら	反救世譚
えすけーぷもじ	エスケープ文字
えすててぃか	鬼畜美学
えせかがく	似非科学
えそう	壊相
えぞ	恵蘇
えたーるきほんぐん	エタール基本群
えだ	役
えだ	枝
えだのは	枝葉
えちがわ	愛知川
えっぐまん	卵男
えっこくぶんこ	越國文庫
えっせい	永世
えとう	江藤
えど	江戸
えど	穢土
えどあるど	エドアルド
えどたな	江戸店
えどど	江戸戸
えどわーどざんげおう	エドワード懺悔王
えなが	選永
えなたけみみのみこと	恵奈武耳命
えなめる	琺瑯質
えにわ	恵庭
えのかわ	可愛川
えのきだ	榎田
えのやま	可愛山
えば	江波
えばらのしょう	荏原庄
えびおりがみ	海老折神
えびがたなだいみょうおろし	海老刀大名おろし
えびごて	海老籠手
えびす	恵比寿
えびすちょうえき	恵美須町駅
えびぜめ	海老責
えびでぃすく	海老ディスク
えびはらりよこ	蝦原理代子
えびばさみ	海老ばさみ
えびばさみほんてがえし	海老ばさみ本手返し
えびろくりんだん	海老六輪弾
えぴそーど	挿話集
えふとり	冒険譚
えほば	江帆波
えまき	絵巻
えみこ	恵美子
えめらるど	緑玉
えやみ	病疾
えら	択
えら	鰓
えり	簄
えり	英莉
えりおっとはどう	エリオット波動
えりか	恵梨香
えりな	恵理奈
えりーと	将
えるだー	大老
えるだーどらごんぞく	混代竜族
えるだーゔぁんぱいあ	高位の吸血鬼
えるふぇんりーと	魔王の凱歌
えるれいのはこ	エルレイの匣
えれくたー	有権者
えれじー	望郷歌
えれめんとしゅうげきは	五大元素蹴撃破
えん	塩
えん	炎
えん	閻
えんあん	宴安
えんうじ	役氏
えんえいけんのろし	煙叡剣狼煙
えんえんちょうだのじゅつ	蜿蜒超蛇の術
えんおう	延応
えんおう	鴛鴦
えんかべんぞいる	塩化ベンゾイル
えんがる	遠軽
えんきごう	円記号
えんきどう	円軌道
えんきはいれつ	塩基配列
えんきん	遠近
えんくう	円空
えんくうざん	陥空山
えんこう	遠高
えんごう	閻剛
えんさいくろぴぢあ	百科通覧
えんしぇんとどらごん	真竜
えんしぇんとどらごん	神代竜族
えんしょう	塩沼
えんしんしきあっしゅくき	遠心式圧縮機
えんじ	偃路
えんじ	園兒
えんじ	臙脂
えんじいろ	臙脂色
えんじぇる	怪物
えんじゃく	燕雀
えんじゅ	槐
えんじょう	円成
えんじょうは	炎上破
えんじん	炎神
えんじんきしぜん	炎刃騎士漸
えんじんだいしょうぐん	炎神大将軍
えんそう	演奏
えんそうしゃ	演奏者
えんちゃんたー	付与術師
えんちゃんたー	執行者
えんちゃんと	口寄せ
えんとく	延徳
えんどう	遠藤
えんにちもの	縁日物
えんのうばそく	役優婆塞
えんのぎょうじゃ	役行者
えんぷてぃ	銘無し
えんぺらーどらごん	竜王
えんほう	燕邦
えんぽう	延宝
えんまだいおう	閻魔大王
えんまだいかりん	焔摩大火輪
えんまらじゃ	閻魔羅闍
えんみ	厭魅
えんみこどく	厭魅蠱毒
えんらおう	閻羅王
えんりゃく	延暦
えんりゅう	炎竜
えんりゅうげき	炎龍撃
えんりゅうせんぷうげきは	炎龍旋風撃波
えんれつだん	焔裂断
えゔぉるたー	精霊操者
おあつらえむき	御誂向
おい	於
おい	置
おい	美味
おいし	生石
おいずる	笈摺
おいそ	老蘇
おいぬあな	生犬穴
おいまいけ	男井間池
おう	応
おうあん	応安
おういん	王印
おうか	黄花
おうかしょう	桜花賞
おうかんすう	凹関数
おうきしちせいは	王気七星破
おうきゅう	王宮
おうぎまち	扇町
おうご	小河
おうごんきしがろ	黄金騎士ガロ
おうごんきしがろ	黄金騎士牙狼
おうごんきしがろおん	黄金騎士ガロ闇
おうごんきしがろしょう	黄金騎士ガロ翔
おうごんけん	黄金剣
おうごんじょおうれでぃごーるど	黄金女王レディゴールド
おうさか	逢坂
おうさにょぜかん	応作如是観
おうしゅう	王湫
おうしゅうしりつひがしみずさわちゅうがっこう	奥州市立東水沢中学校
おうしょう	横生
おうしょくくみあい	黄色組合
おうずいこう	黄瑞香
おうそうけい	黄宗敬
おうたい	黄体
おうち	楝
おうちょう	応長
おうつい	殴槌
おうとうへんすう	応答変数
おうとく	応徳
おうにん	応仁
おうのこおり	意宇郡
おうはい	王配
おうばくさん	黄檗山
おうばくしゅう	黄檗宗
おうぶん	横文
おうべい	欧米
おうべいしょこく	欧米諸国
おうべいしょこくじん	欧米諸国人
おうほう	応保
おうみ	淡海
おうみ	近江
おうむしんりきょうほうそう	オウム真理教放送
おうりんがろ	鷹麟牙狼
おうりんちょう	鷹麟鳥
おうりんのや	鷹麟の矢
おうわ	応和
おえつ	嗚咽
おお	大
おおあざじゅうろくちょう	大字拾六町
おおあざはねど	大字羽根戸
おおあま	大海人
おおいけ	大池
おおいなるいち	巨イナル一
おおいなるたそがれ	巨イナル黄昏
おおいわい	大祝
おおうち	大内
おおおよそ	大凡
おおかみいろ	狼色
おおかみおとこ	狼男
おおかみざ	おおかみ座
おおかみしゅりけん	狼手裏剣
おおかや	大萱
おおかわ	大川
おおかわ	大河
おおかわばた	大川端
おおがい	大会
おおがたしんじん	大型神陣
おおがわら	大川原
おおき	大
おおき	大木
おおぎまち	扇町
おおくさかのきみ	大日下王
おおくにぬしのかみ	大国主神
おおぐす	大楠
おおぐもだいしゅりょう	大蜘蛛大首領
おおげつひめのかみ	大気都比売神
おおこうち	大河内
おおさか	大阪
おおさかかぶきざ	大阪歌舞伎座
おおさかしろな	大阪しろな
おおさかもん	大阪産
おおさき	大崎
おおさざきのみこと	大雀命
おおすかんのんどおり	大須観音通
おおすが	大須賀
おおすげ	大菅
おおすまち	大須町
おおすみけ	大角家
おおず	大州
おおずまち	大洲町
おおぞら	大空
おおぞら	穹蒼
おおぞらぎり	大空斬り
おおぞらだいちぎり	大空大地斬り
おおた	太田
おおたけ	大武
おおたしもまち	太田下町
おおたらしひこおしろわけのすめらみこと	大帯日子於斯呂和気天皇
おおだいこ	大太鼓
おおち	邑智
おおつか	大塚
おおづち	青土
おおづつ	大砲
おおとしのかみ	大年神
おおとちのかみ	大橡神
おおとの	大殿
おおとのすめらみこと	男大迹天皇
おおとり	鳳
おおどじま	大戸島
おおどのみこと	袁本杼命
おおなむちのみこと	大己貴命
おおぬさ	大麻
おおの	大野
おおはつせわかたけのみこと	大長谷若建命
おおはまかはんどおり	大浜河畔通り
おおはまどおり	大浜通り
おおはらのむら	大原野村
おおばく	大博
おおばやし	大林
おおひばし	大樋橋
おおひら	大平
おおひるめのむちのかみ	大日霊貴尊
おおぶか	大深
おおぶち	大淵
おおほうり	大祝
おおほり	大濠
おおほりこうえん	大濠公園
おおぼしゆらのすけ	大星由良之助
おおぼねおつ	大骨折
おおまた	大股
おおまちだんち	大町団地
おおみや	大宮
おおみやじ	大宮主
おおむら	大村
おおものぬしのかみ	大物主神
おおもん	大門
おおやがわ	大谷川
おおやけ	公
おおやすみやま	大休山
おおやすみやまどおり	大休山通り
おおやまつみのかみ	大山祇命
おおやまづみじんじゃあとこうえん	大山祇神社跡公園
おおやまとたらしひこくにおしひとのみこと	大倭帯日子国押人命
おおやまとねこひこくにくるのみこと	大倭根子日子国玖琉命
おおやまとねこひこふとにのみこと	大倭根子日子賦斗迩命
おおやまとひこすきとものみこと	大倭日子鍬友命
おおやまねずのみこと	大山ねずの命
おおやままち	大山町
おおやまもりのみこと	大山守命
おおわだのとまり	大輪田泊
おか	地
おか	岡
おか	陵
おか	陸
おかざき	岡崎
おかざわ	丘沢
おかしなしすたーず	お菓子なシスターズ
おかだ	岡田
おかだま	丘珠
おかちまち	御徒町
おかにん	陸忍
おかみ	主上
おかみ	聖上
おかゆ	おかゆ
おかよう	陸用
おがいと	小垣内
おがたとしくに	緒方季晋
おがわらこ	小川原湖
おき	熾
おきだいとうじま	沖大東島
おきついわたてのかみ	奥津石建神
おきて	掟
おきなかし	沖仲仕
おきなが	息長
おきはまいなりじんじゃ	沖濱稲荷神社
おきび	熾火
おきめのおみな	置目老媼
おきんたいがわ	沖台川
おぎはぎのみこと	意岐萩命
おぎわら	荻原
おく	屋
おく	置
おく	送
おくい	奥井
おくうあいぜん	屋烏愛染
おくがき	奥書
おくだ	奥田
おくづけ	奥付
おくとろわ	入市関税
おくひのつち	奥火の土
おくぶたえ	奥二重
おくりな	諡
おぐら	小倉
おぐろ	尾畔
おけのみこと	意祁命
おこ	起
おこう	神使
おこた	懈
おことひめ	於琴姫
おこのみしだい	御好次第
おこり	瘧
おごそ	厳
おごそ	小許曽
おさかべ	刑部
おさごうや	長高野
おさだ	訳語田
おさつ	長都
おさつまわくごのすくねのみこ	男浅津間若子宿禰王
おさない	小佐内
おさむ	宰
おさらいかい	温習会
おさん	阿三
おさんなんみん	お産難民
おざさ	小笹
おざわ	小沢
おし	唖
おし	忍
おし	惜
おし	推
おしきの	青色野
おしくま	押熊
おしくまのみこ	忍熊王
おしひろ	拡
おしぶね	押船
おしべ	雄蕊
おしみのみやつこのおおくに	忍海造大国
おしゃもじん	男石神社
おしょういお	和尚魚
おしょうろぶね	お精霊舟
おじ	伯父
おじけ	怖気
おじさんこうぶん	おじさん構文
おすえ	御末
おすたにあ	東国
おすべだい	尾芼台
おせちご	長稚児
おぜき	小磧
おそ	恐
おそごえ	獺越
おそれのちから	恐れの力
おた	小田
おたえ	於妙
おたく	偽恋
おたつま	御立馬
おたふくかい	御多福会
おたる	小樽
おだ	小田
おちあいふしなりきゅうり	落合節成胡瓜
おちくぼ	乙窪
おちけん	落研
おちゃまん	大茶万
おちゃや	御茶屋
おちわけのみこと	於知別命
おっかけ	追っかけ
おっさか	忍坂
おっちゅう	淡中
おっとせい	海狗腎
おっぱがわ	追波川
おっぺがわ	越辺川
おついち	乙一
おつむ	頭
おでさん	五台山
おと	墜
おと	声
おとう	御頭
おとえい	乙頴
おとぎみ	弟君
おとこ	漢
おとこ	男
おとこい	乙女恋
おとこがさ	男笠
おとだけ	音田家
おとな	音無
おとひ	弟日
おとひひめこ	弟日姫子
おとひめはーとでらぶきゅうでん	乙姫心で恋宮殿
おとまね	音真似
おとめ	童女
おともにんしゅりけん	オトモ忍シュリケン
おとり	囮
おとりさま	お酉様
おとりやく	囮役
おとろ	衰
おとわ	音羽
おど	小戸
おどし	脅迫
おどろ	駭
おどろ	驚
おなぎ	小名木
おなご	女子
おなり	御成
おにうち	鬼打ち
おにおど	鬼威
おにこうべ	鬼首
おにご	鬼子
おにたけまる	鬼剛丸
おにどめ	鬼止め
おににわ	鬼庭
おにばらい	鬼払い
おにびしれい	鬼火司令
おにびばしら	鬼火柱
おにへい	鬼平
おにへいはんかちょう	鬼平犯科帳
おにまる	鬼丸
おにゅう	遠敷
おぬしゅ	鬼主
おの	己
おのおの	各
おのおのこと	各異
おのこう	小野高
おのずか	自
おのだ	小野田
おのでら	小野寺
おのみなと	雄湊
おのれ	己
おはつせのわかさざきのみこと	小長谷若雀命
おばば	老奶奶
おばまにちゅう	小浜二中
おひきずり	お引き摺り
おびただ	夥
おびつ	帯津
おびれ	尾鰭
おぶち	尾駮
おぶつそうじほう	汚物掃除法
おぺ	執刀
おほ	大
おほうみ	大海
おほきさき	大后
おほさぎのみかど	大雀皇帝
おほさざきのみこと	大雀命
おほたらしひこおしろわけのすめらみこと	大帯日子淤斯呂和氣天皇
おほとのべ	大斗乃辨神
おほどのみこと	袁本杼命
おほはつせのわかたけ	大泊瀬稚武
おほはつせわかたけのみこと	大長谷若建命
おほみ	大御
おほみうた	御製歌
おほみこと	勅命
おほみこと	詔
おほみこと	詔旨
おほものぬしのかみ	大物主神
おほやけ	公
おほやまとたらしひこくにおしひとのみこと	大倭帯日子國押人命
おほやまとねこひこくにくるのみこと	大倭根子日子國玖琉命
おほやまとねこひこふとにのみこと	大倭根子日子賦斗邇命
おほやまとひこすきとものみこと	大倭日子鉏友命
おぼ	覚
おぼ	覺
おまえいけ	御前池
おまえさき	御前崎
おまへ	汝
おむにあ	森羅万象
おむら	御紫
おめ	御馬
おめがこうほう	オメガ航法
おも	思
おも	想
おも	欲
おもいつ	思付
おもいつき	思付
おもかげ	俤
おもしろ	面白
おもちち	母父
おもて	表
おもてけい	表罫
おものがわ	鬼面川
おもひつき	思付
おもほしめす	所念行
おもむき	致
おもむろ	徐
おもり	錘
おや	親
おやこさんだいにんれつざん	親子三代忍烈斬
おゆき	お雪
およ	凡
およ	及
おら	俺
おらんだ	荷蘭
おらんだご	オランダ語
おらんだまる	和蘭丸
おりあげごうてんじょう	折上格天井
おりかえしざつおん	折り返し雑音
おりがみだいかいほう	折神大開砲
おりさき	御裏崎
おりすけ	折助
おりづ	下津
おりづるのまい	折鶴之舞
おりづるへんげ	折り鶴変化
おりーぶ	橄欖
おりーぶゆ	オリーブ油
おる	天狼
おるちに	小流智尼
おるむ	丘
おるりこ	オルリコ
おれ	俺
おれ	勇者
おろ	苙
おろし	卸
おろしも	下物
おろそか	疎
おろち	大蛇
おろのしまししょ	小呂島支所
おろのもと	苙の元
おわ	畢
おわぞう	御阿蔵
おわりね	終値
おわりのしゅりけん	終わりの手裏剣
おんえい	恩栄
おんがくか	音楽家
おんけんは	穏健派
おんげきがっそう	音撃合奏
おんげきだ	音撃打
おんこうとくじつ	温厚篤実
おんざき	御前
おんしつこうかがす	温室効果ガス
おんじゅうけんすずね	音銃剣錫音
おんせん	音泉
おんそ	音素
おんたいしょう	御大将
おんでし	御弟子
おんど	温度
おんどく	音読
おんな	女
おんながさ	女笠
おんなやもめ	女寡
おんねんろ	怨念炉
おんびん	穏便
おんぶ	音部
おんぷがんま	音符眼魔
おんみょうじ	陰陽師
おんむん	諺文
おーそひゅーまん	在来型ヒト
おーだー	要請
おーとまた	自動人形
おーとれーすせんしゅ	オートレース選手
おーばるすたっふ	魔導杖
おーばー	奪
おーばーど	夜明譚
おーばーれい	情報偽装
おーぶ	宝珠
おーぶめんと	導力器
おーろら	北極光
おーゔぁらいど	封神電戯
かあ	姑
かい	回
かい	海
かい	蓋
かい	解
かい	階
かいき	回帰
かいきぶんせき	回帰分析
かいこ	蚕
かいこく	開国
かいこく	開國
かいこくいぜん	開国以前
かいこくしゆぎ	開国主義
かいさじ	貝匙
かいざん	改竄
かいざー	皇帝
かいしゃくせんげん	解釈宣言
かいしゃごろ	会社ゴロ
かいしゅん	買春
かいじゅう	禍威獣
かいじゅうおう	怪獣王
かいせい	快晴
かいせいろう	開勢樓
かいせき	解析
かいぞうそるじゃー	改造戦士
かいちこどもみこし	開智子供神輿
かいていげんじん	海底原人
かいてんうち	回転撃ち
かいでにん	海出人
かいと	海斗
かいとうげ	海藤花
かいとうこんごう	快刀金剛
かいとうらんま	快桃乱麻
かいどうじ	怪童子
かいな	腕
かいはつけいざいがく	開発経済学
かいはら	萱原
かいびやく	開闢
かいほうきねんび	解放記念日
かいぼう	解剖
かいらい	傀儡
かいらいか	傀儡化
かいろうやま	海老山
かうじん	幸甚
かうせい	恒星
かうせい	校正
かうせいちう	恒星中
かうんせん	加恩線
かえ	帰
かえ	返
かえつ	却
かえるせんしゃ	カエルせんしゃ
かえん	火宴
かえん	火焔
かえんけんれっか	火炎剣烈火
かえんしょうぐんけん	火炎将軍剣
かえんじごく	火炎地獄
かえんじゅうじざん	火炎十字斬
かえんたいしょう	火焔大将
かえんたつまきざん	火炎竜巻斬
かえんだか	火炎鷹
かえんだん	火宴弾
かえんどはつてん	火炎怒髪天
かえんのまい	火炎の舞い
かえんぶひざん	火炎舞飛斬
かえんめろでぃざん	火炎旋律斬
かえんんらいでんのまい	火炎雷電の舞い
かおう	嘉応
かおうがた	花押型
かおす	華悪崇
かおる	薫
かおるこ	薫子
かか	拘
かか	斯
かかあでんか	かかあ天下
かかか	火火火
かかざ	嬶座
かかざん	花果山
かかちょう	荷花庁
かかと	踵
かかとお	踵落
かかりちょう	係長
かかわ	拘
かかんし	可韓司
かがうめばち	加賀梅鉢
かががさ	加賀笠
かがく	科学
かがくかくめい	科学革命
かがくけつごう	化学結合
かがくとくべつそうさたい	科学特別捜査隊
かがくひん	化学品
かがすげがさ	加賀菅笠
かがふときゅうり	加賀太胡瓜
かがふり	冠
かがみ	加上
かがみ	加賀美
かがみせんこうがえし	鏡閃光返し
かがりび	燎火
かがりび	篝火
かがわしうん	香川紫雲
かがわちょうかわひがしかみ	香川町川東上
かがんさんげい	火眼狻猊
かき	花卉
かきうち	垣内
かきつ	嘉吉
かきつづ	書綴
かきぬま	柿沼
かきのそで	垣の袖
かきのもとのひとまろ	柿本人麻呂
かきやま	舁山
かぎ	鎰
かぎはらゆか	鍵原ユカ
かぎやづくり	鉤屋作り
かぎり	限
かく	嘉挧
かく	核
かく	格
かく	此
かく	玃
かく	角
かく	香
かくえねるぎー	核エネルギー
かくか	核果
かくか	角果
かくご	覺悟
かくざ	擱座
かくしゃく	矍鑠
かくしょうばいあす	確証バイアス
かくしよ	各処
かくしん	鑊身
かくぜん	覚禅
かくだいせいさんしゃせきにん	拡大生産者責任
かくちょうし	拡張子
かくと	殻斗
かくとか	殻斗果
かくどうばる	角銅原
かくの	此
かくのふゆ	核の冬
かくはん	撹拌
かくばくだん	核爆弾
かくばんさいばい	隔板猜枚
かくぶ	角部
かくぶ	革部
かくま	匿
かくみさいる	核ミサイル
かくめい	革命
かくゆうごうはんのう	核融合反応
かくらい	加倉井
かくらん	撹乱
かくらん	攪乱
かくりつてきあるごりずむ	確率的アルゴリズム
かくりつみつどかんすう	確率密度関数
かくりよ	幽世
かくれだいしょうぐん	隠大将軍
かくれつごう	隠烈剛
かくれりゅうらいめいざん	隠流雷鳴斬
かぐつちのかみ	火神迦具土神
かぐつちゆうじ	迦具土神遊児
かぐや	赫夜
かぐや	輝夜
かぐら	覚羅
かけ	駆
かけい	嘉慶
かけい	筧
かけだし	掛出
かけぢゃや	掛茶屋
かけひ	謎解
かげ	影
かげ	翳
かげき	過激気
かげきぼうけんこんじょうげき	過激気冒険根性撃
かげさわ	影沢
かげつ	香月
かげのまい	影の舞
かげまつ	影松
かげみ	影美
かげみせ	陰店
かげみのじゅつ	影身之術
かげろう	陽炎
かげろうぶんしん	陽炎分身
かげろふ	蜻蛉
かげん	嘉元
かげんいしゃ	加減医者
かこい	栫
かこく	猳国
かこやく	水主役
かご	歌語
かご	訛語
かごかき	駕籠舁
かごさかのみこ	香坂王
かごしまけんぎかい	鹿児島県議会
かごちゃまる	鹿児茶丸
かごめ	加護女
かさ	傘
かさ	笠
かさあみりょう	笠網漁
かさい	河西
かさいりゅうげきだん	火砕流撃弾
かさおか	笠岡
かさな	重
かさのりもく	カサノリ目
かさほこ	傘鉾
かさみつど	嵩密度
かさもん	笠紋
かざ	文
かざはな	風花
かざみけいじ	風見刑事
かざわ	金沢
かざんふんしゅつぶつ	火山噴出物
かし	下賜
かし	瑕疵
かし	白檮
かしおぺやざ	カシオペヤ座
かしこ	畏
かしこきあたり	畏き辺り
かしはらのみや	白檮原宮
かしひのみや	詞志比宮
かしゅ	窩主
かしょう	嘉承
かしょう	寡照
かしら	頭
かしらがき	頭書
かしわり	柏里
かじ	梶
かじ	齧
かじかわ	梶川
かじがもり	梶ヶ森
かじきいっとうりょうだん	舵木一刀両断
かじきおりがみ	舵木折神
かじきごりんだん	舵木五輪弾
かじきでぃすく	舵木ディスク
かじた	梶田
かじちょうてい	家事調停
かじや	嘉司屋
かす	掠
かすがい	鎹
かすみ	霞
かすみだに	霞谷
かすみだにしちにんしゅう	霞谷七人衆
かすみのじょー	霞のジョー
かず	數
かずえまちちゃやがい	主計町茶屋街
かずきめ	海女
かずは	一葉
かずま	兆麻
かずみ	和美
かせい	河清
かせき	可夕
かせやま	鹿背山
かせんりゅう	火閃竜
かぜ	烈風
かぜ	疾風
かぜい	課税
かぜたぬき	風貍
かそう	火葬
かぞ	計
かた	固
かた	形
かた	語
かた	鞏
かたくち	片口
かたくらべのみこと	片倉辺命
かたげんしゅ	肩原種
かたしき	型式
かたじき	片膳
かたすみ	片隅
かたたたき	迦汰蛇滝
かただだんち	片田団地
かたち	定型
かたち	貌
かたつむり	蝸牛
かたなこう	刀工
かたびらつじ	帷子辻
かたみ	記念
かたやままがいしゅじ	片山磨崖種子
かたりて	語り手
かたりべ	語り部
かたりもの	語り物
かたわ	傍
かち	勝
かちどき	凱鬼
かちどきばた	カチドキ旗
かっくうき	滑空機
かっこ	羯鼓
かっこんだ	葛根田
かっこんとうかせんきゅうしんい	葛根湯加川芎辛夷
かっせいさくごうたい	活性錯合体
かっそく	活捉
かったつ	濶達
かったつ	闊達
かっぱ	喝破
かっぷる	双騎士
かつ	嘗
かつ	曾
かつあんしき	活罨式
かつおとりしま	鰹鳥島
かつげがわ	葛下川
かつしか	葛飾
かつでぃすく	活ディスク
かつなる	勝全
かつにい	カツ兄
かつら	加都良
かつらい	桂井
かつろ	瞎驢
かづらき	葛城
かていないぼうりょく	家庭内暴力
かてん	火点
かでんし	価電子
かでんつぁ	舞闘
かとうしやくわい	下等社會
かとうゆきねえさん	加藤有紀姉さん
かとくたい	禍特対
かとくたい	科特隊
かとり	香取
かど	角
かどのおさ	看督長
かな	假名
かな	叶
かな	哀
かな	悲
かな	愛
かない	家内
かない	金居
かなえ	花苗
かなえ	香奈枝
かなが	河永
かなしいぐゎ	愛しい子
かなじ	金持
かなだらいじごくおとし	金だらい地獄落とし
かなで	奏
かなどうろう	金燈籠
かなはしのみや	金箸宮
かなまき	金巻
かなまり	金鋺
かなみ	華菜美
かなやまひこ	金山比古
かなやまひめ	金山比売
かなよかなよ	愛よ愛よ
かなら	必
かなわ	金輪
かなわ	鉄輪
かにゅう	加入
かぬちぼう	頭貫棒
かね	兼
かね	金
かね	鉄
かね	鐘
かねいし	金石
かねじゃく	曲尺
かねだ	金田
かねらか	カネラ科
かの	彼
かの	鹿乃
かのう	加納
かのくに	彼国
かのじょ	妹
かのじょ	姉
かのじょ	魔王
かのまたがわ	鹿股川
かのん	輪唱
かはら	箇播羅
かはんぶ	下半部
かば	庇
かばとぐん	樺戸郡
かばどの	蒲殿
かばね	姓
かばのかじゃ	蒲冠者
かばのき	樺の木
かばれん	樺連
かばん	鞄
かひ	下邳
かひこ	蚕
かひつ	加筆
かひのり	加比の理
かび	黴
かふ	寡夫
かふ	寡婦
かふぇ	珈琲店
かふか	鹿深
かふきゆう	過不及
かふち	川内
かぶ	冠
かぶ	禾部
かぶ	被
かぶこう	甲高
かぶしきがいしゃ	株式会社
かぶと	冑
かぶと	鹿伏兎
かぶといし	兜石
かぶとおおざる	兜大猿
かぶとおりがみ	兜折神
かぶとごりんだん	兜五輪弾
かぶとだいかいてんほう	兜大回転砲
かぶとでぃすく	兜ディスク
かぶとほう	兜砲
かぶとらいげきは	カブト雷撃破
かぶぬし	株主
かぶぬししほんりえきりつ	株主資本利益率
かぶりがさ	被り笠
かぷりちお	狂騒曲
かほ	芳
かほう	嘉保
かほう	火砲
かぼう	仮冒
かまいたち	鎌鼬
かまえみや	構宮
かましょい	釜背負
かまた	鎌田
かまて	鎌手
かまど	竈
かまぼこやき	蒲鉾焼
かまやうす	釜谷臼
かみ	上
かみ	神
かみ	軍神
かみ	長官
かみあかびらえき	上赤平駅
かみあたつひめ	神吾田津姫
かみありし	神在市
かみかいで	上開田
かみかず	紙數
かみかぜたいしょう	神風大将
かみかぜたくしー	神風タクシー
かみかわばたまち	上川端町
かみがたかぶき	上方歌舞伎
かみがみ	神々
かみこじま	神子島
かみごいちにん	上御一人
かみごふくまち	上呉服町
かみしも	裃
かみしろ	神代
かみしんかい	上真海
かみじょう	上条
かみだんじり	上地車
かみつみ	上道
かみつやこけ	髪艶苔
かみて	上手
かみなが	髪長
かみながひめ	長髪比売
かみなりだましい	雷魂
かみにしまち	上西町
かみにしまちどおり	上西町通り
かみにんいちぞくとうりょう	紙忍一族頭領
かみのかま	神竈穴
かみのかままつり	神竈穴祭
かみのたな	上之店
かみむすび	神産巣日神
かみむた	上牟田
かみむら	上村
かみやそうたん	神屋宗湛
かみやまこうこう	神山高校
かみやまち	神屋町
かみよななよ	神世七代
かむあが	崩
かむあたかあしつひめ	神吾田鹿葦津姫
かむあたつひめ	神阿多都比売
かむが	稽
かむさ	薨
かむさすか	勘察加
かむざね	神実
かむちゃっか	神着火
かむつけのみねお	上野岑雄
かむぬなかはみみのみこと	神沼河耳命
かむやまといはれびこのすめらみこと	神倭伊波禮毘古天皇
かむやまといはれびこのみこと	神倭伊波禮毘古命
かむやまといわれひこのみこと	神日本磐余彦尊
かむろ	禿
かむわかたまのかみ	神稚魂神
かめ	甌
かめお	亀夫
かめおとこ	亀男
かめおりがみ	亀折神
かめかめか	亀噛火
かめがおか	亀ヶ丘
かめた	亀太
かめだ	亀田
かめだな	亀店
かめでぃすく	亀ディスク
かめんらいだーあまき	仮面ライダー天鬼
かもつゆそう	貨物輸送
かものきみぬかめ	鴨君粳女
かもんじゅく	掃部宿
かもんづつみ	掃部堤
かやりび	蚊遣り火
かやりび	蚊遣火
かよう	个様
かよちょう	加与丁
かよちょうぐち	駕輿丁口
から	空
からくりへんげんかたな	カラクリヘンゲン刀
からくりへんげんつめ	カラクリヘンゲン爪
からくりへんげんゆみ	カラクリヘンゲン弓
からこおどり	唐子踊
からじし	唐獅子
からす	烏
からす	鴉
からすみだいにしこうとうがっこう	鳥見台西高等学校
からすやま	烏山
からだ	身体
からてんじく	唐天竺
からとまりししょ	唐泊支所
からとみち	唐櫃道
からびつ	唐櫃
からめてばし	搦手橋
からーどらごんぞく	色竜族
かり	假
かり	雁
かりそ	苟
かりそう	仮葬
かりそめ	苟
かりていもはんじゃ	訶梨帝母般闍
かりぶかい	カリブ海
かりぶし	仮臥
かりも	釭
かりもち	假用
かりゃく	嘉暦
かりや	刈谷
かりゅう	火龍
かりゅうじゅうげきは	火龍重撃波
かりょう	過料
かりん	火輪
かりんだんかえんじん	火輪弾火焔陣
かりー	嘉例
かる	可留
かる	軽
かるかやどう	苅萱堂
かるた	骨牌
かるでぃなーれ	護法枢機卿
かるのおほいらつめ	軽大郎女
かるのひつぎのみこ	軽太子
かるべはかせ	軽部博士
かるんうぇなん	聖泉の双紋剣
かるーでぃあ	天翔虎
かれ	彼
かれ	故
かれい	加齢
かれん	カレン
かれん	華漣
かれんとっぱ	可憐突破
かろ	輕
かろがいはくはくしゅとう	栝楼薤白白酒湯
かろがいはくはんげとう	栝楼薤白半夏湯
かろく	嘉禄
かろしょうじき	火爐焼食
かわいい	可愛い
かわかみ	川上
かわかみおとじろう	川上音二郎
かわかみちかます	川上親埤
かわぎし	川岸
かわぎり	川霧
かわさき	川崎
かわじり	川尻
かわずや	蛙屋
かわせ	河瀬
かわちれんこん	河内蓮根
かわづ	河津
かわない	川相
かわまた	川俣
かわむら	河村
かわらけ	土器
かわらけやま	土器山
かわらけやまのたたかい	土器山の戦い
かわらちょう	河原町
かわらふき	瓦葺
かわらまち	瓦町
かを	薫
かん	観
かん	閑
かん	関
かんいかつぱつ	敢為活溌
かんうぉんらんど	江原ランド
かんえ	寛衣
かんえう	肝要
かんか	柑果
かんか	鰥寡
かんかんがくがく	侃々諤々
かんかんしょう	貫貫掌
かんかんだ	貫貫打
かんが	考
かんがえ	考
かんがく	漢学
かんき	刊記
かんきょ	官許
かんきょうばんぐみ	環境番組
かんけん	乾繭
かんげん	咸絃
かんげん	諫言
かんこう	慣行
かんこう	甘汞
かんこう	邗溝
かんこうれい	緘口令
かんこくうぉん	韓国ウォン
かんこくがく	韓国学
かんこくきょういくかていひょうかいん	韓国教育課程評価院
かんこくきょういくほうそうこうしゃ	韓国教育放送公社
かんこくぐんいあんふ	韓国軍慰安婦
かんこくご	韓国語
かんこくごか	韓国語科
かんこくごぞく	韓国語族
かんこくごちょうせんごやくせいしょ	韓国語朝鮮語訳聖書
かんこくてきいけん	勧告的意見
かんこくのきりすときょう	韓国のキリスト教
かんごう	嵌合
かんさく	寒浞
かんさつ	鑑札
かんざき	神崎
かんし	乾屍
かんし	諫止
かんしゃく	癇癪
かんしょ	甘薯
かんしょう	鑑賞
かんじゅ	贛珠
かんじょうしょうがい	感情障害
かんじろうきゅうり	勘次郎胡瓜
かんせい	閑靜
かんせい	陥穽
かんせつみんしゅしゅぎ	間接民主主義
かんせつみんしゅせい	間接民主制
かんせん	艦船
かんぜおんぼさつ	観世音菩薩
かんぜん	間然
かんぜんきたい	完全気体
かんぞうげんしゅ	肝臓原種
かんたい	閑岱
かんだい	函大
かんとう	間島
かんとうえん	甘棠園
かんとうかん	甘棠館
かんとく	寛徳
かんとん	小郡
かんとん	広東
かんなぎ	巫
かんなぎ	神祇官
かんなでやま	神撫山
かんなべ	燗鍋
かんなむら	神無村
かんぬなかわみみのみこと	神沼河耳命
かんのおさ	神長
かんはとり	神服
かんはんとう	韓半島
かんばせ	顔
かんばつ	旱魃
かんばら	神原
かんぶりま	カンブリ魔
かんへきさんぼう	涵碧山房
かんぺん	官辺
かんまち	上町
かんみそさい	神御衣祭
かんやさい	カンヤ祭
かんやまといわれびこのみこと	神倭伊波礼毘古命
かんよう	甘蠅
かんらん	橄欖
かんらんゆ	橄欖油
かんり	奸利
かんれい	慣例
かんれき	還暦
かんろ	甘露
かーご	貨物船
かーてん	帷
かーどや	カード屋
かーねりあ	紅耀石
がい	害
がいか	凱火
がいか	蓋果
がいかくていり	外角定理
がいきそう	鎧気装
がいきだいじんきたねいだす	害気大臣キタネイダス
がいきゅう	外舅
がいきゅう	鎧球
がいこく	外国
がいこくごきょういく	外国語教育
がいこつまる	骸骨丸
がいさい	外債
がいしょ	涯諸
がいしょくさんぎょう	外食産業
がいすいきしうずまきほーて	害水機士ウズマキホーテ
がいすいだいじんけがれしあ	害水大臣ケガレシア
がいせい	凱聖
がいせん	凱旋
がいぜん	慨然
がいそうざん	鎧装斬
がいちだいじんよごしゅたいん	害地大臣ヨゴシュタイン
がいちふくだいじんひらめきめです	害地副大臣ヒラメキメデス
がいとうりょうばっちーど	害統領バッチード
がいねん	概念
がいねんきかん	外燃機関
がいはく	薤白
がいふう	凱風
がいほう	艾蓬
がいむ	鎧武
がいむあーまー	鎧武アーマー
がいら	骸羅
がいりきたいしょうぶらんけん	凱力大将ブランケン
がいりやく	概略
がいりゅうえでる	鎧竜エデル
がおう	牙王
がおのほうじゅ	ガオの宝珠
がかんはせん	俄館播遷
がかんろせん	俄館露遷
がく	学
がく	萼
がくえん	楽園
がくけ	楽家
がくしや	學者
がくしゅうしょうがい	学習障害
がくじゅつ	学術
がくせいぶ	学生部
がくもん	学問
がくもん	學問
がくゆう	学友
がげん	雅言
がごぜ	元興寺
がざいがんま	画材眼魔
がしゃどくろようしゅりけん	ガシャドクロ妖シュリケン
がじゅつ	莪朮
がじゅつ	莪蒁
がぜるきゃく	ガゼル脚
がぜん	俄然
がた	難
がっしんぎんがとうし	合身銀河闘士
がったいせんとういん	合体戦闘員
がったいにんしゅりけん	合体忍シュリケン
がってんしょうち	合点承知
がっぽ	合浦
がてん	合点
がとうとう	雅桐刀
がとうりんぐ	雅桐倫俱
がとりんぐ	銃乱打
がとりんぐがん	回転式機関砲
がひ	飼
がまがまじゅう	ガマガマ銃
がましゅりけん	ガマ手裏剣
がまほうし	蟇法師
がむ	雅武
がもん	衙門
がゆうかい	雅友会
がら	壷
がらいほうし	我雷法師
がらくたまちきたん	我楽多街奇譚
がらす	玻璃
がらす	硝子
がららばこ	殻落箱
がりょう	臥龍
がりょうざん	臥龍山
がれき	瓦礫
がわ	曲輪
がわうけ	側受
がん	巌
がん	癌
がんかい	眼界
がんかすい	岩罅水
がんがたいかく	含牙戴角
がんがんなっくるおとし	頑頑ナックル落とし
がんぎょう	元慶
がんじがため	玩茨固
がんじゃく	雁石
がんせききょじんろっくくりむぞん	岩石巨人ロッククリムゾン
がんせきさいまじゅうまぐまごれむ	岩石サイマ獣マグマゴレム
がんそーでぃあ	銃剣姫
がんとうのかん	巌頭之感
がんまあいこん	眼魔眼魂
がんまかんすう	ガンマ関数
がんまろうごく	眼魔牢獄
がんれつぱんち	岩烈パンチ
がーでぃあん	守護戦士
がーでぃあん	守護神
がーでん	双月花
きあかしし	黄赤獅子
きあし	黄脚
きい	忌諱
きいろ	黄
きう	喜雨
きういげきりん	キウイ撃輪
きうえいろう	久榮樓
きうぐんき	舊軍旗
きうじやうか	舊城下
きうたらうべつたらう	久太郎別太郎
きうち	木内
きうちことこ	木内琴子
きえみのじゅつ	消え身の術
きえみのじゅつ	消身之術
きおくそうち	記憶装置
きおくぶそうし	棄憶武装士
きか	奇貨
きか	季夏
きか	麾下
きかい	棋界
きかいおう	機械王
きかいかじゅう	機械化獣
きかいかじょう	機械化城
きかいかていこく	機械化帝国
きかいにんちゅう	機械忍蟲
きかいようさいたーみねる	機械要塞ターミネル
きかつ	飢渇
きかん	機関
きかんしゃまわし	機関車回し
きかんぼう	鬼カン棒
きかんぼうちょうかんちらかそーね	危官房長官チラカソーネ
きが	飢餓
きがう	記號
きがんせき	奇厳岩
きき	窺基
きき	聞
ききかんりし	危機管理士
ききき	嬉々稀
ききょう	桔梗
ききょうがさ	桔梗笠
きぎゅう	夔牛
きぎょう	基業
きぎょう	起業
きぎょうか	起業家
きぎょうれんごう	企業連合
きくせん	鞠羨
きくわん	機關
きぐう	寄寓
きぐるみ	着ぐるみ
きけいえんえんしょとかんぎき	徽慶園園所都監儀軌
きこ	木興
きこう	熙皞
きこう	綦江
きこうしじゅにあ	貴公子ジュニア
きこしめ	聞食
きごう	記号
きさき	前
きさき	后
きさきほうりつじむしょ	妃法律事務所
きさらぎのむすめ	如月の娘
きさんじゅつ	鬼傘術
きざみ	刻
きざる	黄猿
きしぞうし	鬼子草子
きしだ	岸田
きしのえき	己巳役
きしべ	岸辺
きしぼ	鬼子母
きしもと	岸本
きしゃ	滊車
きしゃがさ	騎射笠
きしゅん	季春
きしょう	亀松
きしょうがく	気象学
きしょうよほう	気象予報
きしよう	気象
きしりゅういっとうりゅうそうざん	騎士竜一桃リュウソウ斬
きしん	寄進
きしん	鬼神
きじつがいはくけいしとう	枳実薤白桂枝湯
きじゅ	喜寿
きじんぞく	鬼人族
きす	酒
きすう	基数
きすう	帰趨
きずつ	傷
きせい	寄生
きせき	奇蹟
きせき	耆碩
きせつちょうせい	季節調整
きせん	棋戦
きせん	滊船
きせんひんぷ	貴賤貧富
きぜい	亀筮
きそ	基礎
きぞう	寄贈
きた	來
きた	来
きたかんとう	北関東
きたがた	北方
きたがみ	北上
きたがわ	北川
きたがわれいすけ	北川礼弼
きたきゅうしゅう	北九州
きたきゅうほうじまち	北久宝寺町
きたざき	北崎
きたじま	北島
きたじょうし	北条氏
きたちょう	木太町
きたとりしま	北鳥島
きたのたち	北の館
きたはま	北浜
きたはまざいもくまち	北浜材木町
きたふるばばまち	北古馬場町
きたむらひでとし	北村秀敏
きたよばんちょう	北四番丁
きちおか	吉岡
きちじょうけかえ	吉祥悔過会
きちじょうまにほうしょうにょらい	吉祥摩尼宝生如来
きちにい	吉兄
きちょう	貴重
きっさぽあろ	喫茶ポアロ
きっす	接吻
きって	切手
きつさこうかつ	譎詐狡猾
きつと	屹度
きつりつ	屹立
きてぃ	仔猫
きでんしょうらい	気伝招来
きでんぶじん	気伝武人
きどあいらく	喜怒哀樂
きどうしゅう	鬼道衆
きどうばがれおぱるさー	機動馬ガレオパルサー
きどうぶしごんげむ	機動武士ゴンゲム
きどうぼう	喜動房
きどがわ	木戸川
きないしちどう	畿内七道
きにんざん	黄忍斬
きぬ	布
きぬ	衣
きぬぎぬ	後朝
きぬくば	衣配
きぬた	砧
きぬひも	衣紐
きねんぼう	鬼念坊
きの	木野
きのう	気嚢
きのうてきひしきじ	機能的非識字
きのした	木下
きのたま	酒の玉
きは	際
きはだがに	黄蘗蟹
きはら	鬼原
きはんし	軌範師
きば	呀
きば	木場
きば	黄羽
きばいなずま	牙稲妻
きばおうが	牙王牙
きばおにじょう	牙鬼城
きばだいおう	牙大王
きばとっしん	牙突進
きばのげきりん	機刃の激輪
きばばしり	牙走り
きび	其美
きび	癸未
きびだんご	黍団子
きふう	氣風
きふじんはなびのまい	貴婦人花火ノ舞
きぶ	亀部
きぶ	虫部
きぶ	鬼部
きぶつちんし	寄物陳思
きぶね	貴布禰
きぶみのほんじつ	黄書本実
きぶんしょうがい	気分障害
きべんじゅつ	鬼鞭術
きぼうのみち	希望の光
きぼつのち	鬼歿之地
きまわし	機回し
きみ	君
きみ	王
きむじゃん	沈蔵
きむら	木村
きめじま	鬼女島
きもう	悕望
きもんでん	木門田
きゃうし	僵尸
きゃく	脚
きゃくしつじょうむいん	客室乗務員
きゃすりんぐ	入れ替え転移
きゃっか	脚架
きゃっかんてききぞくろん	客観的帰属論
きゃっぷ	代表
きゃつ	彼奴
きゃのん	砲
きゃぷたーやぐら	キャプター櫓
きゃら	伽羅
きやく	客
きやだに	鬼矢谷
きやませんせい	鬼山先生
きゅう	球
きゅう	虬
きゅうあん	久安
きゅういま	宮衣亦
きゅうき	窮奇
きゅうきち	久吉
きゅうきょ	急遽
きゅうきょくきゅうえもん	究極九衛門
きゅうきょくだいじゅうじん	究極大獣神
きゅうぎじょう	球技場
きゅうけつうちゅうじん	吸血宇宙人
きゅうけんぽう	旧憲法
きゅうしのつえ	九歯の杖
きゅうしゅうぎんこう	株式会社九州銀行
きゅうしゅうてつどう	九州鉄道
きゅうじゅ	久寿
きゅうせいしゅのぶらじら	救星主のブラジラ
きゅうせいふつかよいずつうけん	急性二日酔い頭痛拳
きゅうせいようさいらびりんでる	救星要塞ラビリンデル
きゅうたい	裘袋
きゅうたろう	九太郎
きゅうたろうまち	久太郎町
きゅうてんかんこんがん	九転還魂丹
きゅうてんげんにょにゃんにゃん	九天玄女娘々
きゅうとうちけいせい	九頭雉鶏精
きゅうねったいく	旧熱帯区
きゅうはさまがわ	旧迫川
きゅうひん	弓浜
きゅうびこりせい	九尾狐狸精
きゅうぶ	臼部
きゅうぶ	韭部
きゅうぼのせん	窮暮之戰
きゅうもく	休沐
きゅれーたー	管理者
きゆう	旧
きゆうへいしゆう	旧弊習
きゆうりずかい	窮理図解
きょ	裾
きょ	距
きょうあい	狭隘
きょういくがくぶ	教育学部
きょううんし	狂雲子
きょうえん	狂宴
きょうおう	姜黄
きょうか	莢果
きょうかすいげつのじゅつ	鏡花水月の術
きょうがく	驚愕
きょうき	強鬼
きょうこ	京子
きょうこ	叫呼
きょうさ	夾叉
きょうしきくみん	境識倶泯
きょうしゅ	梟首
きょうしゅうせん	挟蹴旋
きょうじ	梟示
きょうじゅ	教授
きょうじゅうらでぃがん	凶獣ラディガン
きょうじん	強靭
きょうせい	強制
きょうせいしせつけいひきょうどうたい	矯正施設警備矯導隊
きょうせいしょぶん	強制処分
きょうせいしょぶんほうていしゅぎ	強制処分法定主義
きょうそう	競漕
きょうだい	兄弟
きょうだい	姉弟
きょうだいしまいかんのぎゃくたい	兄弟姉妹間の虐待
きょうだいにんれつざん	兄妹忍烈斬
きょうとう	郷党
きょうとう	驚濤
きょうとうし	強闘士
きょうとく	享徳
きょうとてつどう	京都鉄道
きょうどうしんけん	共同親権
きょうのきみ	卿公
きょうひ	胸痺
きょうぼく	喬木
きょうまく	莢膜
きょうや	京谷
きょうゆうけつごう	共有結合
きょうゆうでんたいめもり	強誘電体メモリ
きょうようしゅぎ	教養主義
きょうらんどとう	狂瀾怒桃
きょうりゅうおりがみ	恐竜折神
きょうりゅうたんく	恐竜戦車
きょうりゅうでぃすく	恐竜ディスク
きょうりゅうとう	恐竜刀
きょうりゅうぶじんらいじゃ	恐竜武人ライジャ
きょうりゅうまるてんちいっせん	キョウリュウマル天地一閃
きょうりゅうや	恐竜や
きょうろう	拱廊
きょうろく	享禄
きょか	炬火
きょか	許可
きょが	巨壑
きょきゃくげんしゅ	巨脚原種
きょくせいけん	極星拳
きょくせいこうはしゅりけん	極星光波手裏剣
きょくたい	極体
きょこう	炬光
きょし	鋸歯
きょじん	巨神
きょじんぞく	巨人族
きょだいかばくだん	巨大化爆弾
きょだいぎょかいじゅう	巨大魚怪獣
きょちょう	秬鬯
きょっけい	極刑
きょっこう	曲江
きょまん	巨万
きょりゅう	叫竜
きょわんげんしゅ	巨腕原種
きょんじぇ	経済
きょんじゅいんたーちぇんじ	慶州インターチェンジ
きょんちゃ	軽車
きよ	浄
きよ	清
きよ	神聖
きようきゆう	匡救
きようきよう	驕矜
きようく	恐懼
きようしや	驕奢
きようまん	驕謾
きよかしよせい	居家處世
きよかわ	清川
きよくごう	極功
きよくじつ	旭日
きよくちしようけい	曲知小慧
きよねんらい	去年來
きよはらうぢ	清原氏
きよひと	清仁
きよみ	清美
きら	木良
きらあとうきょう	鬼羅亜頭狂
きらいしょうげきは	輝雷襲撃波
きらいとう	鬼雷党
きらいばくげきは	鬼雷爆撃破
きらいまる	鬼雷丸
きらり	希来里
きり	錐
きり	霧
きりうり	切売
きりおん	霧音
きりかぐれねろさいぞう	霧隠ネロ才蔵
きりこ	切子
きりこ	霧子
きりさき	霧崎
きりすときょうべじたりあにずむ	キリスト教ベジタリアニズム
きりづまやね	切妻屋根
きりとおし	錐通
きりは	切羽
きりふだ	切札
きりゅう	機龍
きりょうかい	鬼霊界
きりょくあたっく	気力アタック
きりょくえんかくぎり	気力遠隔斬り
きりょくぼんばー	気力ボンバー
きりんくせつべん	麒麟九節鞭
きりんぐべあ	殺人熊
きりんけんろっどあろー	麒麟拳ロッドアロー
きりんばくだんぱんち	麒麟爆弾パンチ
きれえ	嫌
きれつ	罅裂
きろはた	木路畑
きわ	極
きわ	究
きわま	窮
きわみ	極
きわめ	窮
きをく	記憶
きん	欣
きん	釁
きん	金
きんかくだいおう	金角大王
きんかはむ	金華ハム
きんきせんにん	欣喜仙人
きんきゅうじたいじょうこう	緊急事態条項
きんきゅうじたいせんげん	緊急事態宣言
きんぎょも	金魚藻
きんこ	緊箍
きんこ	金子
きんこう	金虹
きんこく	金穀
きんこじ	緊箍児
きんさこう	金鎖甲
きんしゃ	禽舎
きんじょう	金城
きんじょうじゅ	緊縄呪
きんじょうてんのう	今上天皇
きんせんさいけん	金銭債権
きんぜん	欣然
きんたがー	慶武田川
きんだいおりんぴっく	近代オリンピック
きんだいびじゅつ	近代美術
きんちゅう	禁中
きんとうざんきんとうどう	金兜山金兜洞
きんとうん	觔斗雲
きんとき	公時
きんとき	金時
きんとらのおもく	キントラノオ目
きんにくげんしゅ	筋肉原種
きんにくてききりすときょう	筋肉的キリスト教
きんぶ	金部
きんぽうげ	毛莨
きんま	蒟醤
きんらん	錦襴
きんり	禁裏
きんりゅうまち	金立町
きーにんぐ	精霊姫
きーる	龍骨
ぎえんきん	義捐金
ぎえんきん	義援金
ぎおんご	擬音語
ぎおんまち	祇園町
ぎかかぎこひんゆうげんこんす	技嘉科技股份有限公司
ぎが	嶬峨
ぎけいあん	義経庵
ぎけいりゅう	義経流
ぎしょう	義消
ぎじかがく	疑似科学
ぎじご	擬似語
ぎじゅつしゃ	技術者
ぎじゅつとこころ	技術と精神
ぎせいご	擬声語
ぎそういたく	偽装委託
ぎそうはけん	偽装派遣
ぎたいご	擬態語
ぎたいさく	擬対策
ぎたいほう	擬態法
ぎてき	儀狄
ぎふとめーかー	聖杯使い
ぎぼし	擬宝珠
ぎまん	欺瞞
ぎむしょうぼうたい	義務消防隊
ぎゃくひ	逆比
ぎゃるご	ギャル語
ぎゃんぶるいそんしょう	ギャンブル依存症
ぎゅうい	及已
ぎゅうけん	牛券
ぎゅうし	牛脂
ぎゅうとう	牛刀
ぎゅうまおう	牛魔王
ぎゅうらく	牛酪
ぎゅうりょく	牛力
ぎょう	顒
ぎょうあん	暁闇
ぎょうえい	仰叡
ぎょうこてん	凝固点
ぎょうこてんこうか	凝固点降下
ぎょうじ	行事
ぎょうじゃ	孫行者
ぎょうじゃがさ	行者笠
ぎょうせいかんしょよういん	行政官署要員
ぎょうせいほうがく	行政法学
ぎょうてんごう	仰天号
ぎょうねん	行年
ぎょうぶのじょう	刑部丞
ぎょくおんばん	玉音盤
ぎょくさんかい	玉山会
ぎょくさんくらぶ	玉山クラブ
ぎょくていこく	玉珮国
ぎょくと	玉兎
ぎょくりゅう	玉竜
ぎょくりゅう	玉龍
ぎょたい	魚袋
ぎょぶ	魚部
ぎょらいえいぞう	魚雷映蔵
ぎよぶ	禦侮
ぎらさめざんこくけん	ギラサメ残酷剣
ぎり	斬
ぎりぎり	限界集落
ぎりしあご	ギリシア語
ぎりしゃせいきょう	ギリシャ正教
ぎろう	妓樓
ぎろちん	断頭台
ぎんいと	銀糸
ぎんかえん	銀火炎
ぎんかくだいおう	銀角大王
ぎんが	銀牙
ぎんがいけん	銀鎧剣
ぎんがかいぶつかいじゅるぎん	銀河怪物カイジュルギン
ぎんがきしぜろ	銀牙騎士絶狼
ぎんがくろす	ギンガ聖衣
ぎんがけんしびりおん	銀河剣士ビリオン
ぎんがこうていめどー	銀河皇帝メドー
ぎんがごうりゅうしゅうれっぱ	銀河轟龍蹴烈破
ぎんがしょうにんどんごろす	銀河商人ドンゴロス
ぎんがじゅうあんもないとん	銀河獣アンモナイトン
ぎんがじゅうおうぎり	銀河獣王斬り
ぎんがじゅうおうむじんぎり	銀河獣王無尽斬り
ぎんがじゅうげきだん	銀河獣撃弾
ぎんがせんたいぎんがまん	銀河戦隊ギンガマン
ぎんがたまご	銀河卵
ぎんがだいじゅうおうぎり	銀河大獣王斬り
ぎんがちょうじゅうばるがいやー	銀河超獣バルガイヤー
ぎんがとうし	銀河闘士
ぎんがのきばざざ	銀河の牙ザザ
ぎんがのせんこう	銀河の戦光
ぎんがのひかり	ギンガの光
ぎんがはかせどるどら	銀河博士ドルドラ
ぎんがまじんばーるぎん	銀河魔神バールギン
ぎんがみ	銀紙
ぎんがゆうじょうしゅうれっぱ	銀河友情蹴烈破
ぎんこ	銀狐
ぎんさじのたち	銀砂地の太刀
ぎんさん	銀傘
ぎんしたけみつ	銀紙竹光
ぎんしろう	銀志郎
ぎんせん	銀閃
ぎんせんこう	銀閃光
ぎんせんぷう	銀旋風
ぎんてい	銀鋌
ぎんふぶき	銀吹雪
ぎんろうまんげつぎり	銀狼満月斬り
くぁんじゅくうこう	光州空港
くぁんじゅこういきし	光州広域市
くいせ	杭瀬
くいなづか	水鶏塚
くいんしー	滅却師
くいーん	女王
くう	空
くうかん	空間
くうきぶんりそうち	空気分離装置
くうくうぼうぼう	空々茫々
くうぐんどくりつろん	空軍独立論
くうぐんばんのうろん	空軍万能論
くうげき	空隙
くうしゅ	空手
くうしんけん	空神拳
くうちゅうぎり	空中斬り
くうちゅうていしん	空中挺進
くうてい	空挺
くうでん	宮殿
くうゆていしん	空輸挺進
くうれつぱんち	空烈パンチ
くえん	枸櫞
くが	久我
くがたち	盟神探湯
くきょうい	究竟位
くぎみや	釘宮
くけはさま	洞迫
くげよう	公家様
くさ	草
くさ	草蔬
くさいだま	臭い玉
くさかり	草刈
くさがえ	草香江
くさがえうすいたいすいち	草ケ江雨水滞水池
くさぞうし	臭草紙
くさはら	草原
くさば	草場
くさび	轄
くさん	柜山
くし	臭
くしきりょう	公式令
くしけず	梳
くしげ	櫛笥
くしばやし	櫛林
くしびき	櫛引
くしまちのみこと	櫛真智命
くしゃろん	倶舎論
くしゅんこたん	楠渓
くしゅんない	楠苗
くじゃく	孔雀
くじゅう	九重
くじゅうくしま	九十九島
くじら	鯨
くじらい	鯨井
くじらまく	鯨幕
くす	楠
くすし	医
くすし	薬師
くすのき	楠
くすのき	楠木
くすりし	薬師
くず	国栖
くずみ	久住
くずも	車尾
くずりゅうじん	九頭龍陣
くずりゅうむら	九頭流村
くずれ	頽
くぜ	久世
くぞう	供僧
くだ	降
くちあいにん	口合人
くちづけ	接吻
くちばし	嘴
くちよう	口調
くつがえ	顛覆
くつわ	轡
くに	国
くに	州
くにいちき	国渭地祇
くにいへ	国家
くにえだ	邦枝
くにがえ	国替
くにがら	国柄
くにきだ	国木田
くにざかい	国境
くにしのびうた	思国歌
くにしゅう	国衆
くにじとう	国地頭
くにちさい	国土祭
くにつのみやつこ	国造
くにつふみ	国記
くにつもの	信物
くにのくりや	國厨
くにのとこたち	国之常立神
くにびと	郷人
くにみだい	州見台
くぬぎ	櫟
くぬぎや	椚屋
くのうら	来浦
くは	加
くび	括
くび	頸
くび	馘首
くびき	軛
くびきてつどう	頸城鉄道
くびげんしゅ	首原種
くふう	工風
くまおりがみ	熊折神
くまかへかさ	熊谷笠
くまがい	熊谷
くまがいかご	熊谷籠
くまがいがさ	熊谷笠
くまき	熊木
くまこ	神子
くまさか	熊坂
くましゅりけん	熊手裏剣
くましろ	神代
くまそたける	熊襲タケル
くまでぃすく	熊ディスク
くまやま	熊山
くみがさ	組笠
くみこ	久美子
くめのすけ	条之助
くも	雲
くもぎ	雲城
くものす	蜘蛛の巣
くゆ	燻
くゆうのしゅうじ	倶有の種子
くよく	鸜鵒
くら	食
くらい	位
くらいどりきすうほう	位取り記数法
くらおのおおかみ	闇龗大神
くらき	倉木
くらけん	鞍腱
くらし	生活
くらしっく	洋楽
くらしっくおんがく	クラシック音楽
くらしな	倉科
くらた	倉田
くらたはまかんたくち	倉田浜干拓地
くらはし	倉橋
くらぶ	較
くらまこぼうず	闇間小坊主
くらもと	倉本
くらやみしれい	暗闇指令
くらやみじゅう	暗闇獣
くらやみぼうまじんば	暗闇暴魔ジンバ
くらゐ	位
くりえいと	祭器練生
くりからもんもん	倶利迦羅紋々
くりこみぐん	くりこみ群
くりすたわるきゅーれ	水晶機装の戦姫
くりやがわ	厨川
くるざたぜー	黒砂糖ぜー
くるざたぜーくゎ	黒砂糖ぜーくゎ
くるしみ	苦しみ
くるしゅう	倶盧洲
くるまがさ	車笠
くるまざきのけい	車裂きの刑
くるめ	泝洄
くれ	伎
くれいじー	奇人
くれいじーどらごん	狂竜
くれおん	球麗温
くれきぎょう	呉基業
くれっぱ	空裂波
くれないとりのこがみ	紅鳥ノ紙
くれないまる	くれない丸
くれのはな	呉華
くれはし	呉橋
くれはら	呉原
くれぶそるみでぃうむそうこう	クレブソルミディウム藻綱
くれりっく	施療神官
くろ	黒鋼
くろいえ	黒い絵
くろいわかんとく	黒岩監督
くろかげ	黒影
くろがね	鉄
くろがねけん	黒鉄剣
くろがねへんけい	黒鉄変形
くろき	黒木
くろきば	黒牙
くろこ	黒子
くろこうもり	黒蝙蝠
くろことうげ	黒河峠
くろころぼっと	黒子ロボット
くろさかえきまえ	黒坂駅前
くろさめごう	黒鮫号
くろさわ	黒沢
くろざとうしゅ	黒砂糖酒
くろざとうじょうちゅう	黒砂糖焼酎
くろじゅうじおう	黒十字王
くろじゅうじじょう	黒十字城
くろじゅうじそうとう	黒十字総統
くろじゅうじのきゅうせいしゅぶらじら	黒十字の救星主ブラジラ
くろじゅうじのそうりだいじんよごしまくりたいん	黒十字の総裏大臣ヨゴシマクリタイン
くろじゅうじのめいふしんだごん	黒十字の冥府神ダゴン
くろすぎり	クロス斬り
くろすせき	クロス積
くろすふぁいやー	十字仮面
くろずくめのそしき	黒ずくめの組織
くろだ	黒田
くろどうし	黒道士
くろぬま	黒沼
くろねっかーのきょくげんこうしき	クロネッカーの極限公式
くろのす	九瓏ノ主
くろひめ	黒日売
くろへびだん	黒蛇団
くろぼう	黒坊
くろらぶきょうじゅ	黒ラブ教授
くろろでんどろんそうこう	クロロデンドロン藻綱
くろんぼう	黒ん坊
くわ	加
くわ	精
くわ	銜
くわ	鍬
くわい	回
くわいらく	快樂
くわうせん	光線
くわえいつうご	華英通語
くわしつ	過失
くわしほこいずたけをのみこと	精矛厳健雄命
くわだ	企
くわつぱつ	活溌
くわつぱつ	活發
くわぽ	戈浦
くわみずまち	神水町
くわん	卷
くわん	觀
くわんのん	観音
くわんみんじやうか	官民上下
くんいく	葷粥
くんしょうちだつれい	勲章褫奪令
くんじゅう	薫習
くんすー	困死
くんたん	燻炭
くんとう	薫陶
くんびー	困斃
くんふー	功夫
くんみんせいおん	訓民正音
くーしゃんびょう	克山病
くーろん	庫倫
ぐいのみ	ぐい呑み
ぐうぜん	偶然
ぐうぞう	偶像
ぐうぞうすうはい	偶像崇拝
ぐうわ	寓話
ぐきゅうみょうち	愚丘妙智
ぐし	髪
ぐじん	愚人
ぐずぐず	愚図愚図
ぐたべ	具多遍
ぐっず	脇役
ぐのーしす	叡智
ぐのーしす	真なる叡智
ぐのーむ	地精
ぐびじんそう	虞美人草
ぐらうんどぜろ	黄金城跡地
ぐらはむれいきゃくき	グラハム冷却器
ぐらびとん	蔵備頓
ぐらんどどらごん	地竜
ぐらんどますたー	盟主
ぐらーるりったー	星杯騎士団
ぐらーゔぇ	重々しく
ぐりもわーる	魔導書姫
ぐりーす	紅麗威甦
ぐりーんどらごんぞく	緑竜族
ぐるぐる	具流虞留
ぐるぐるけん	車車拳
ぐるぐるびりびり	具流虞留備離美利
ぐるじあご	グルジア語
ぐるじお	偶龍爾王
ぐれのむれ	愚れノ群れ
ぐれんき	紅蓮騎
ぐれんのつき	紅蓮の月
ぐれんのもり	紅蓮の森
ぐれーとあくたー	演技派
ぐわんらい	元來
ぐんじ	軍事
ぐんじょう	群青
ぐんだりやしゃみょうおう	軍荼利夜叉明王社
ぐんようきん	軍用金
ぐーたん	古弾
ぐーる	不死姫
けあらし	気嵐
けい	罽
けいあい	敬愛
けいあん	慶安
けいうん	慶雲
けいえい	桂栄
けいおう	慶応
けいかい	鯨海
けいがく	桂萼
けいきのう	頚気嚢
けいきょうたい	警矯隊
けいけん	敬虔
けいけんしゅぎ	経験主義
けいけんろん	経験論
けいこ	恵子
けいこ	桂子
けいこうたんぱくしつ	蛍光タンパク質
けいこく	熒惑
けいさい	掲載
けいさつこっか	警察国家
けいさんもでる	計算モデル
けいざい	経済
けいざいがくしゃ	経済学者
けいざいどうぶつ	経済動物
けいざんに	瓊山尼
けいしき	形式
けいしちょう	警視庁
けいじ	啓司
けいじそしょうほう	刑事訴訟法
けいじばん	掲示板
けいじょう	京城
けいじょうりえき	経常利益
けいすけ	恵介
けいせい	京成
けいせい	奎星
けいせいびょういん	慶聖病院
けいせんえき	桂川駅
けいた	圭太
けいたいにんとうはやてまる	携帯忍刀ハヤテ丸
けいちゆう	閨中
けいついねんざ	頸椎捻挫
けいていしまい	兄弟姉妹
けいてん	啓典
けいと	毛糸
けいとう	雁来紅
けいとうし	軽闘士
けいば	競馬
けいばつ	刑罰
けいひおとし	螢灯落とし
けいひきょうどうたい	警備矯導隊
けいひん	京浜
けいびん	慧敏
けいほう	刑法
けいまい	兄妹
けいめいくとう	鶏鳴狗盗
けいめいだいがく	慶明大学
けいもう	啓蒙
けいもうせんせいくんしゅ	啓蒙専制君主
けいもくろう	奎木狼
けいよう	京葉
けいようしく	形容詞句
けいりん	経綸
けいれん	痙攣
けう	希有
けが	怪我
けが	汚
けがれ	穢
けぎょうい	加行位
けご	警固
けさ	袈裟
けさお	袈裟尾
けし	芥子
けしごむだいかん	消しゴム代官
けしずみからす	消炭鴉
けしつぶ	罌粟粒
けせつ	仮設
けせんがわ	気仙川
けた	桁
けたあがりのよんめいか	桁上がりの四名家
けだ	蓋
けちずそう	血塗相
けっかてきかじゅうはん	結果的加重犯
けっきょく	結局
けっこんきねんしき	結婚記念式
けっさつ	結紮
けっしょう	結晶
けっせんさつ	血仙殺
けっせんちゅう	血仙蟲
けっていけいすう	決定係数
けってきほう	闕腋袍
けつ	决
けつじょう	決定
けつじょうみみかざり	玦状耳飾
けつだん	决斷
けつてい	決定
けつぶ	穴部
けつぶ	血部
けつぶ	頁部
けつべつ	訣別
けづめ	蹴爪
けにあきょうわこく	ケニア共和国
けはいね	気配値
けひのおおかみ	気比大神
けびいし	検非違使
けふぇうすざ	ケフェウス座
けぶり	烟
けぷらーのほうそく	ケプラーの法則
けぼねや	毛骨屋
けま	食満
けまきゅうり	毛馬胡瓜
けまこうもん	毛馬閘門
けまはいすいきじょう	毛馬排水機場
けみょう	仮名
けみょう	仮名世間
けむ	煙
けむり	煙
けもがみだんし	けも神男子
けもの	獣
けものつかい	獣使い
けらうのす	天の雷
けらく	快楽
けらくどう	快楽道
けるきおん	夜刀神
けるん	核
けん	権
けんいち	健一
けんいつ	憲一
けんえきたんちけん	検疫探知犬
けんえん	蘐園
けんえんじゅく	蘐園塾
けんか	喧嘩
けんかし	県柏
けんかじょうとう	喧嘩上刀
けんかたばみ	剣片喰
けんがく	賢学
けんぎ	剣義
けんぎょう	検校
けんぐん	健軍
けんげん	乾元
けんげんない	権限内
けんこう	謙降
けんこんいってきぶじゅつかい	乾坤一擲武術会
けんご	健吾
けんご	堅固
けんさくかこう	研削加工
けんさつかん	検察官
けんさつかんかんよけってい	検察官関与決定
けんさん	研鑽
けんしょう	憲章
けんしょうぶどー	剣将ブドー
けんじつ	芡実
けんじゅう	犬戎
けんじんきしがいあ	堅陣騎士ガイア
けんじんとりん	賢神トリン
けんせい	権勢
けんせいじろうしんくん	顕聖二郎真君
けんせき	譴責
けんたうるすざ	ケンタウルス座
けんたん	健啖
けんちょう	懸吊
けんつけどり	剣付鶏
けんでん	喧伝
けんとぅむご	ケントゥム語
けんとく	建徳
けんとづか	間斗束
けんどちょうらい	捲土重来
けんにんふくつ	堅忍不屈
けんびはふ	顯微法
けんぶ	見部
けんべん	兼便
けんぽう	憲法
けんぽうきねんび	憲法記念日
けんぽんちゃくしょく	絹本著色
けんもん	水蝹
けんり	権利
けんりゃく	建暦
けんりょくぶんりつ	権力分立
けんれんたいしょう	捲簾大将
げい	羿
げい	芸
げい	黥
げいしや	藝妓
げいじゅつたいいくよういん	芸術体育要員
げいじゅつよういん	芸術要員
げき	外記
げき	戟
げき	檄
げき	激気
げきけんさん	激気研鑚
げきげきぜんびーすとほう	激激全ビースト砲
げきげきびーすとほう	激激ビースト砲
げきげきほう	激激砲
げきげきりんりんざん	激激臨臨斬
げきこう	激昂
げきごういつ	激気合一
げきさい	撃摧
げきさっか	劇作家
げきじょうたい	激情態
げきちゅうにゅう	激気注入
げきとうし	激闘士
げきとうば	激闘場
げきりゅういっとう	激流一刀
げきりゅうけん	撃龍剣
げきりゅうしょう	撃竜衝
げきりゅうじん	撃龍神
げきりんけん	激臨剣
げきりんろうろうざん	激臨狼狼斬
げきれつだんしょう	激烈断掌
げきれつだんだ	激烈断打
げぎょう	現形
げご	外護
げごく	下獄
げざ	下座
げしも	下司名
げしん	下神
げじんみつきょう	解深密経
げす	下司
げっかいさんかんきいん	月海山観喜院
げっこうき	月光機
げっしょくかめんじゃーくむーん	月蝕仮面ジャークムーン
げっしんきょう	月神鏡
げっちゅうせんじょ	月中蟾蜍
げつい	孑遺
げどうしんけんれっど	外道シンケンレッド
げどうふくめつ	外道覆滅
げほうがり	外法狩り
げるまんそご	ゲルマン祖語
げん	元
げん	言
げんいち	元一
げんえい	元永
げんえいきしくろう	幻影騎士吼狼
げんえんのじゅつ	幻煙の術
げんおう	元応
げんかいじまししょ	玄界島支所
げんかいほう	幻開放
げんかいりえき	限界利益
げんかいりゅう	源海龍
げんかう	原稿
げんき	元亀
げんき	幻気
げんき	弦鬼
げんきがいそう	幻気凱装
げんきじゅうてん	幻気充填
げんきゅう	元久
げんぎょう	現行
げんぎょうくんしゅうじ	現行薫種子
げんこう	元亨
げんごきょういく	言語教育
げんさん	源さん
げんしえねるぎー	原子エネルギー
げんしかく	原子核
げんしかくはんのう	原子核反応
げんしかでんし	原子価電子
げんしたいき	原始大気
げんしよ	原書
げんしりょく	原子力
げんしりょくさいがいはけん	原子力災害派遣
げんしろう	幻死牢
げんしんごうてんへん	幻身豪天変
げんじ	原字
げんじげんぶん	原字原文
げんじょう	玄奘
げんすい	沅水
げんぜい	減税
げんそうじょう	幻双城
げんそく	原則
げんだ	原田
げんだい	現代
げんだいびじゅつ	現代美術
げんだいぶつりがく	現代物理学
げんちゅう	元中
げんとく	元徳
げんな	元和
げんにん	元仁
げんぱち	源八
げんぶ	言部
げんぶしんわ	玄武神話
げんぶばくさい	玄武爆砕
げんぶん	原文
げんぺい	源平
げんぺいかっせん	源平合戦
げんぺいそうらん	源平争乱
げんぺいのたたかい	源平の戦い
げんまちかこ	源馬千佳子
げんむじょう	幻夢城
げんりきごうごうは	幻力豪豪波
げんりゃく	元暦
げんりゅうじん	幻竜神
げんれい	厳厲
げんろういん	元老院
げんろく	元禄
げーと	迎門
げーとどらごん	門番竜
げーむ	作戦
げーむがるど	異世界
こあごひげ	小顎鬚
こいけ	小池
こいずみ	小泉
こいですきーじょう	小出スキー場
こいのうら	己斐浦
こいばしら	恋柱
こいるがたれいきゃくき	コイル型冷却器
こう	公
こう	功
こう	向
こう	国府
こう	好
こう	小
こう	耕
こう	膠
こう	蛟
こう	誥
こうあん	康安
こうあん	弘安
こうあん	苟安
こううびゃくうじん	項羽白羽陣
こううん	光暈
こうえい	康永
こうえき	公益
こうえききんむよういん	公益勤務要員
こうえんたんぶ	口縁端部
こうおう	康応
こうおん	硬音
こうか	江夏
こうかいがいしゃ	公開会社
こうかいさくか	孔開蒴果
こうかくえねるぎーばくてりあ	抗核エネルギーバクテリア
こうかつ	狡猾
こうかん	後患
こうが	嫦娥
こうがい	公害
こうがい	笄
こうがいじ	紅孩児
こうがくごうせい	光学合成
こうがくぶ	工学部
こうがん	睾丸
こうき	高危
こうきじてん	康熙字典
こうきてい	康熙帝
こうきぬ	光絹
こうきん	公瑾
こうきんけんこうごう	孝欽顕皇后
こうきんじょう	幌金縄
こうぎ	交誼
こうぎょくのけい	碧玉の圭
こうくうしゅへいろん	航空主兵論
こうくうゆそうこうどうぐるーぷ	航空輸送行動グループ
こうぐう	光宮
こうぐし	香具師
こうけきもいり	高家肝煎
こうけつ	口訣
こうけつ	膏血
こうけんりえき	貢献利益
こうげき	攻撃
こうげきでぃすく	攻撃ディスク
こうげん	康元
こうこ	江湖
こうこう	後項
こうこう	浩々
こうこう	高高
こうこく	興国
こうこく	鴻鵠
こうこげんのていり	勾股弦の定理
こうこげんのほう	鉤股弦の法
こうこん	後昆
こうこん	黄昏
こうごう	皇后
こうごうけんさいこう	光剛剣最光
こうごうりゅうはざん	光剛龍破斬
こうごんじょう	幌金縄
こうさ	公差
こうさい	交際
こうさいじょうようがん	鉱滓状溶岩
こうさん	猴三
こうざき	神崎
こうざき	香崎
こうざんぜき	鉱山咳
こうし	嚆矢
こうし	孝子
こうしきれい	公式令
こうしち	孝七
こうしゃげん	光射眩
こうしゅうくーろんじょう	甲州九龍城
こうしゅうほけんいし	公衆保健医師
こうしょう	公娼
こうしょう	工廠
こうしょう	康正
こうしりゅうせい	光矢流星
こうしん	皇親
こうしん	興清
こうしんせいだいほうこう	吼新星大咆吼
こうしんてっけんだん	硬芯鉄拳弾
こうじ	康治
こうじ	弘治
こうじつ	後日
こうじゅつ	甲戌
こうじよう	工事用
こうじん	光刃
こうじん	公人
こうじん	荒神
こうじんげん	紅蔘元
こうすいさんかのゆき	江水散花雪
こうずい	光蕋
こうずけのすけ	上野介
こうずち	上有知
こうせい	恒星
こうせつ	交接
こうせつあん	紅雪庵
こうぜん	興繕
こうそ	酵素
こうそう	幸遭
こうそう	紅藻
こうそうぎょう	好相行
こうそく	光速
こうそくけん	高速剣
こうそじょていまざーめるざーど	皇祖女帝マザーメルザード
こうぞ	楮
こうぞうかぷろぐらみんぐ	構造化プログラミング
こうたい	抗体
こうち	交趾
こうちょう	弘長
こうつ	木津
こうつうえいだん	交通営団
こうてつけんりゅう	鋼鉄剣竜
こうてん	皇天
こうてんしし	吼天獅子
こうでんこうか	光電効果
こうとう	勾当
こうとうだいどおり	勾当台通
こうとさんくつ	狡兎三窟
こうど	興戸
こうどう	行動
こうどうしゅぎ	行動主義
こうどじょうほうかしゃかい	高度情報化社会
こうどじょうほうしゃかい	高度情報社会
こうなん	港南
こうにん	弘仁
こうにんかいけいし	公認会計士
こうの	河野
こうのすやまちく	鴻巣山地区
こうはくまく	紅白幕
こうはしゅりけん	光波手裏剣
こうばい	紅梅
こうひ	后妃
こうひあいれん	鴻飛愛蓮
こうひよう	好評
こうび	交尾
こうふく	光復
こうふくせつ	光復節
こうぶ	行部
こうぶ	香部
こうぶ	高部
こうぶ	黄部
こうぶつがく	鉱物学
こうぶてつどう	甲武鉄道
こうへい	公平
こうべ	首
こうべえき	神戸駅
こうほう	康保
こうほうかい	黄袍怪
こうほく	甲北
こうぼう	広袤
こうぼく	厚朴
こうぼく	高木
こうまおう	蛟魔王
こうまくのうきんもん	コウマクノウキン門
こうまざ	こうま座
こうみょういん	光明院
こうみょうしょうよう	光明照耀
こうむ	荷
こうむ	被
こうもり	蝙蝠
こうもんじょ	候門所
こうや	曠野
こうや	高野
こうようかん	紅葉館
こうようしょ	降妖杵
こうらいばし	高麗橋
こうらくえん	甲羅苦円
こうらゆき	香羅雪
こうり	公理
こうりつてきしじょうかせつ	効率的市場仮説
こうりゃく	康暦
こうりゅう	江流
こうりゅうがいせいとう	降竜蓋世刀
こうりょう	虹梁
こうりょう	蛟竜
こうりょうし	光量子
こうろ	紅炉
こうろかん	鴻臚館
こうわ	康和
こうわ	弘和
こえ	聲
こえたご	肥桶
こえどがわ	越戸川
こおとわ	小音羽
こおり	郡
こおりあずき	氷小豆
こおりすい	氷水
こおりのやいば	氷の刃
こおりみず	氷水
こおりみつ	氷蜜
こおろち	小蛇
こか	瓠果
こかげいけ	小川下池
こかご	小籠
こかど	古角
こかわ	小川
こがつおとりしま	小鰹鳥島
こがね	黄金
こがねおおかみ	黄金狼
こがねざね	金札
こがねむらじゅんさ	小金村巡査
こがらし	木枯
こがらしのまい	木枯らしの舞い
こがわ	小川
こがわらぬま	小川原沼
こき	古希
こきふ	呼吸
こきん	古今
こぎんよう	小銀妖
こく	刻
こく	國
こく	斛
こくか	穀果
こくがく	国楽
こくさいいっぱんめい	国際一般名
こくさいきかん	国際機関
こくさいけいざい	国際経済
こくさいけいざいがく	国際経済学
こくさいだんせいでー	国際男性デー
こくさいほう	国際法
こくさいほけんきょうかいれんめい	国際保険協会連盟
こくさいれんごうかんしけんしょうささついいんかい	国際連合監視検証査察委員会
こくさいれんごうけんしょう	国際連合憲章
こくさいれんごうそうかい	国際連合総会
こくじん	黒塵
こくせんぷう	黒旋風
こくそう	黒槍
こくたいどうろ	国体道路
こくちゆう	国中
こくっちょさん	国庁さん
こくとうしゅ	黒糖酒
こくとうしょうちゅう	黒糖焼酎
こくとー	黒糖
こくどちりいん	国土地理院
こくぶ	谷部
こくぶ	黒部
こくみん	国民
こくみんしよがくにゆうもん	国民初学入門
こくみんぜんたい	國民全體
こくみんほけんいりょうのためのとくべつそちほう	国民保健医療の為の特別措置法
こくむちょう	黒夢町
こくもつ	穀物
こくようきしぜむ	黒曜騎士ゼム
こくりゅう	哭竜
こくりゅうぜき	黒竜関
こくりゅうぜき	黒龍関
こけ	苔
こけら	杮
こげつらんぶ	狐月乱舞
こげん	古言
ここ	拳
ここ	是
ここ	爰
ここ	茲
ここうのあらわし	孤高の荒鷲
ここうのとむらい	孤紅の恤
ここち	心地
ここつ	枯骨
ここね	心音
ここのえじん	九重陣
ここのそぢまりいつとせ	九十五歳
ここのそぢまりみとせ	九十三歳
こころ	心
こころ	意
ここんせつかい	古今説海
こさいきん	古細菌
こさか	小坂
こさびがわ	小蛇尾川
こざえもん	小左衛門
こざね	小札
こし	輿
こしがや	越谷
こしき	轂
こしたんたん	虎視眈々
こしゃく	小癪
こしゅ	扈主
こしゅんし	古鰆子
こしょ	古書
こしょうかん	枯松澗
こしょうじ	古小路
こしょくり	股所繰
こしらはざまばし	小白硲橋
こしろう	小四郎
こじ	巾子
こじき	乞食
こじゅう	扈従
こじゅつさいらん	古術彩鸞
こじょう	虎杖
こじょうこん	虎杖根
こすも	小宇宙
こすも	秩序
こすもりうむ	宇宙水槽
こずかたじょう	不来方城
こせんへい	虎先兵
こぜんたいい	虎髯大尉
こそく	姑息
こそで	小袖
こそでのて	小袖の手
こそん	古村
こた	対
こた	小田
こたい	固体
こたつやぐら	炬燵櫓
こたろう	小太郎
こたろう	虎太郎
こだいえじぷと	古代エジプト
こだいおりんぴっく	古代オリンピック
こだまえ	小田前
こだまひこのみこと	児玉彦命
こちご	小稚児
こちゅうじ	胡黜児
こちょう	胡蝶
こっかけんりょく	国家権力
こっかん	克艱
こっき	克己
こっき	骨旗
こっきゅう	黒弓
こっく	厨夫
こっけい	国景
こっけいばなし	滑稽噺
こっけんきしだん	黒剣騎士団
こつき	克己
こつきょく	骨棘
こつぜん	忽然
こつとつ	蓇葖
こつね	小常
こつぶ	骨部
こつまなんきん	勝間南瓜
こづかはらまち	小塚原町
こてんてきじゆうしゅぎ	古典的自由主義
こてんぶ	古典部
こてんめいだいろんり	古典命題論理
こてんりきがく	古典力学
こでんち	古殿地
こと	事
こと	殊
こと	異
こと	言
こと	顧菟
ことあまつかみ	別天津神
ことかた	異方
ことことだま	言言魂
ことさ	故
ことさ	殊更
ことしろぬしのかみ	事代主神
ことだま	言霊
ことづて	言伝
ことは	言葉
ことば	言
ことば	言葉
ことば	語
ことばあそび	言葉遊び
ことばこころ	言意
ことひらじんじゃ	金刀比羅神社
ことぶきしょうてん	壽商店
ことぶきやまごう	寿山号
ことりづかい	部領使
ことわざ	諺
ことわり	理
ことわり	言理
こどうよう	小銅妖
こどく	蠱毒
こどくし	孤独死
こどくぼう	蠱毒房
こども	子供
この	好
この	此
このくに	此国
このころ	頃之
このしろ	飯代魚
このところ	此処
このは	木葉
このはがくし	木の葉隠し
このはなさくやひめのみこと	木花咲弥姫命
このはなさくやひめのみこと	木花咲耶姫命
このはなのさくやびめ	木花之佐久夜毘売
このはなのさくやびめ	木花開耶姫
このはなのさくやびめ	許乃波奈佐久夜比売命
このひ	此日
このへん	此邊
このまた	木俣
こはくがおかじょしこうこう	琥珀ヶ丘女子高校
こはくきゅう	狐白裘
こはま	小浜
こばま	小浜
こばやし	古林
こばやし	小林
こばんちゃやちょう	木場茶屋町
こびきちよう	木挽町
こふがね	小府金
こぶ	瘤
こぶ	虍部
こぶ	鼓部
こぶき	小吹
こぶくろ	小囊
こぶね	小舟
こぶら	毒蛇
こほうこうしれんへき	虎崩靠四連劈
こほん	古本
こまえ	古前
こまか	細
こまきさい	駒木祭
こまきもーたーす	小牧モータース
こまごま	細密
こまだい	駒大
こまなこ	己麻奴跪
こまねえ	コマ姐
こまんだーくろき	コマンダー黒木
こみなみ	小南
こむしゃ	児武者
こむそうあみがさ	虚無僧編笠
こむそうがさ	虚無僧笠
こむろ	小室
こも	籠
こも	菰
こもがわ	菰川
こもちやまんば	嫗山姥
こもはら	薦原
こもり	小森
こもんず	共有地
こもんどまち	古門戸町
こや	昆陽
こやとこ	木屋床
こやのがわ	児屋川
こやま	蚕山
こよく	鼓翼
こよし	小芳
こよみ	古詠
こより	紙縒
こりきたいせん	虎力大仙
こりたき	香燃
こりつし	孤立死
こりつほう	孤立峰
こりのかみ	高麗紙
こりんしゃ	孤輪車
こりんせい	こりん星
これ	之
これ	是
これかげ	維景
これくしょん	蠟燭
これくたー	蒐集家
これくてぃぶ	集成
これひろ	維広
これむね	伊統
これもと	維職
ころう	固陋
ころう	故老
ころう	虎狼
ころうがくしや	故老学者
ころにー	傍世
こわ	怕
こわ	毀
こわい	狐者異
こわもて	強面
こゑ	聲
こん	崑
こん	根
こん	紺
こんこんしょう	魂魂掌
こんこんだん	魂魂弾
こんごういけづきぞうし	金剛生月艸紙
こんごうたく	金剛琢
こんごうにょ	金剛女
こんしゅうばそく	金鷲優婆塞
こんしゅじ	金鐘寺
こんしょうぼさつ	金粛菩薩
こんしんらかん	金身羅漢
こんじき	金色
こんじきおおかみ	金色狼
こんじゃくとげつきょう	今昔渡月橋
こんじょう	金青
こんじょまろ	金杵麿
こんずぎゃてい	金頭掲諦
こんせいまおう	混世魔王
こんぜやま	金勝山
こんぜんし	金蟬子
こんぜんどうじ	金蟬童子
こんだ	金田
こんだい	今代
こんちぇると	協奏曲
こんちゅうけんしみおーら	昆虫剣士ミオーラ
こんちゅうだいひゃっか	昆虫大百科
こんちゅうのはね	昆虫の翅
こんとん	渾敦
こんなん	困難
こんにち	今日
こんにゃくもんどう	蒟蒻問答
こんぱい	困憊
こんべんせきせき	袞冕赤舃
こんぽん	根本
こんやく	困厄
こんりょう	袞龍
こんりんざい	金輪際
こんろん	崑崙
こーちゃんとうおきかいせん	コーチャン島沖海戦
こーど	枷
こーどねーむ	暗号名
ごう	合
ごう	江
ごう	豪
ごういん	強引
ごうかえん	剛火炎
ごうかけんらん	業火絢爛
ごうかせきもうどくだん	轟渦赤猛毒弾
ごうかだいかくめい	豪火大革命
ごうかだん	合花弾
ごうがんふそん	傲岸不遜
ごうごうげき	剛剛撃
ごうごうげきげきしゅーと	轟轟激激シュート
ごうしょう	豪将
ごうじま	豪島
ごうじゅうえいだん	豪獣鋭断
ごうじゅうどりる	豪獣ドリル
ごうじゅうれっくす	豪獣レックス
ごうじゅん	敖閏
ごうせいじゅう	合成獣
ごうせいじゅうきまいらー	合成獣キマイラー
ごうせんぷう	轟旋風
ごうちん	轟沈
ごうてん	轟天
ごうどの	神殿
ごうはどう	轟波動
ごうばら	神原
ごうほういっせん	轟砲一閃
ごうもん	拷問
ごうゆうこうだん	剛勇吼弾
ごうゆうこうは	剛勇吼波
ごうゆうしょうだ	剛勇衝打
ごうよく	剛抑
ごうらい	傲来
ごうらいげき	強雷撃
ごうらいこく	傲来国
ごうらいしん	拷雷震
ごうらいじん	轟雷神
ごうらいせんぷうじん	轟雷旋風神
ごうりゅう	号竜
ごうりゅうがん	剛龍銃
ごうりゅうしゅうれっぱ	轟龍蹴烈破
ごうりゅうじん	剛龍神
ごうりゅうじん	強龍神
ごうれつ	剛烈
ごうれつくらいしん	剛烈駆雷震
ごうわんりき	豪腕力
ごうん	五蘊
ごえく	越来
ごえつどうしゅうじゅうけんがったい	呉越同舟獣拳合体
ごえん	誤嚥
ごかくだいかえん	五角大火炎
ごがんのほうり	五官祝
ごきしちどう	五畿七道
ごきゅうしょ	御休所
ごきりやう	御容量
ごくあくちょう	極悪蝶
ごくあくどうめい	極悪同盟
ごくえんのおーが	獄炎のオーガ
ごくしょまち	御供所町
ごくちょうおおづつ	極超大筒
ごくぼう	極暴
ごくぼうたっぐ	極暴タッグ
ごくまる	獄丸
ごくようせい	御供養星
ごくん	五葷
ごけ	後家
ごけしゅう	牛貨洲
ごけんてい	五剣帝
ごごうごう	五合業
ごごうはた	五合畑
ごしっく	怪綺
ごしゃ	伍奢
ごしょ	御所
ごしょがだに	御所ケ谷
ごしょがだに	御所ヶ谷
ごしんがったい	五神合体
ごじじょう	御治定
ごじっかわ	五十川
ごじゅうご	五五
ごじゅうのたち	五重の太刀
ごすけばしだんそう	五助橋断層
ごせいかい	護星界
ごせいがったい	五星合体
ごせいてんし	護星天使
ごそほうえん	五祖法演
ごたいこく	五大国
ごちそう	御馳走
ごちょうめん	五丁免
ごっどくろすふぁいたー	神竜合士
ごと	如
ごとう	後藤
ごとうし	五島氏
ごとく	五徳
ごとんにんしゅりけん	五トン忍シュリケン
ごとんようしゅりけん	五トン妖シュリケン
ごどう	伍堂
ごどう	悟道
ごどくけん	五毒拳
ごのむら	五ノ村
ごはん	御飯
ごびゅう	誤謬
ごびんでん	御便殿
ごぶんのいち	五分の一
ごへい	伍平
ごへしご	御返事河
ごへんじがわ	御瓶子川
ごほうぎゃてい	五方掲諦
ごみぶち	五味淵
ごや	後夜
ごやくねんらいせぜうのひと	五百年來世上人
ごようくみあい	御用組合
ごりがはま	五里ヶ浜
ごりごりだ	ゴリゴリ打
ごりごりは	ゴリゴリ波
ごりやく	御利益
ごりょうえ	御霊会
ごるんのゔぁそうとう	ゴルンノヴァ総統
ごれむさいまじゅう	ゴレムサイマ獣
ごれんじゅうでんけん	五連獣電剣
ごろう	吾郎
ごんごんけん	厳厳拳
ごんた	ゴン太
ごんぶ	艮部
ごんめもち	五文餅
ごーかいさむらいぎり	ゴーカイ侍斬り
ごーかいむげんしゅりけん	ゴーカイ無限手裏剣
ごーごーけん	轟轟剣
ごーるでんぐろーぶしょう	ゴールデングローブ賞
さい	歳
さい	砕
さいおとこ	犀男
さいおんじはかせ	西園寺博士
さいかつかぜ	細葛風
さいがわ	際川
さいきょう	埼京
さいきん	細菌
さいきんちう	細菌中
さいぎしん	猜疑心
さいげきしゅう	砕撃蹴
さいこ	精神
さいこう	斉衡
さいこうけいえいせきにんしゃ	最高経営責任者
さいこうざいむせきにんしゃ	最高財務責任者
さいこうちしきせきにんしゃ	最高知識責任者
さいごう	西郷
さいごうきょうだい	西郷兄弟
さいし	祭祀
さいしゅうおうぎでぃすく	最終奥義ディスク
さいじゃく	纔著
さいじょう	西条
さいぜん	最前
さいぞう	才蔵
さいたい	妻帯
さいたい	臍帯
さいたいさい	賽太歳
さいたばり	斉田発
さいたん	犀潭
さいだ	斎田
さいだいがんがんけん	砕大頑頑拳
さいだいけん	砕大剣
さいだいげきりんざん	砕大激臨斬
さいだいばくれん	砕大爆連
さいだいもん	西大門
さいだんざ	さいだん座
さいてんとうろうそう	賽転灯籠槍
さいでぃすく	砕ディスク
さいと	咲都
さいとうともき	齋藤知輝
さいなん	災難
さいなんうけあい	災難請合
さいは	鰓耙
さいはいのなりいくさおの	采配形戦斧
さいはいりょく	采配力
さいばんしょ	裁判所
さいほうじ	西方寺
さいほうてん	西方天
さいほんじ	西品寺
さいまじゅう	サイマ獣
さいむ	債務
さいもんうえにんじぞうそん	西門飢人地蔵尊
さうおう	相應
さうざんど	千の魔剣
さうはう	相方
さうりんぼう	草林坊
さえ	紗江
さえぎ	遮
さえもんのじょうけ	左衛門尉家
さお	篙
さおとめもんどのすけ	早乙女主水之介
さか	懋
さか	盛
さかい	坂井
さかい	堺
さかいべ	境部
さかえり	逆襟
さかき	榊
さかきざし	榊差
さかきだまち	榊田町
さかげ	坂下
さかさはりつけ	逆磔
さかたきしゃ	坂田記者
さかづき	盃
さかて	酒手
さかのいち	佐賀市
さかまきのたまゆら	逆巻の玉響
さかまくなみ	驚濤
さかもときゅう	坂本九
さかゆ	栄
さかんこく	沙陥国
さかんなだ	坂灘
さが	捜
さがの	嵯峨野
さがみはらし	相模原市
さがみはんじろきゅうり	相模半白胡瓜
さがりふじ	下り藤
さがわ	佐川
さき	前
さき	咲葵
さき	崎
さき	早紀
さき	未来
さきいけ	佐紀池
さきえだ	崎枝
さきがけ	魁
さきざらし	前晒
さきた	崎田
さきたま	埼玉
さきつよのふること	先代旧辞
さきみたま	幸魂
さきもり	防人
さきやましゅうけい	向山周慶
さぎょうけんさほう	作業検査法
さくおと	桜乙女
さくか	朔果
さくか	蒴果
さくげつ	朔月
さくこだいきゅうり	佐久古太きゅうり
さくさん	柞蚕
さくしんだんとうしゃく	削身断頭芴
さくしーど	継承者
さくたのうなで	裂田の溝
さくら	佐倉
さくら	桜
さくらいのつ	桜井津
さくらがおか	桜が丘
さくらぎ	桜木
さくらざか	桜坂
さくらたちのあしあと	櫻達の足跡
さくらななそうず	櫻七相図
さくらばさま	桜生
さくらびきょうそう	櫻日狂想
さくらみ	桜実
さくらもち	桜餅
さくらわ	桜和
さくらんぼう	錯乱坊
さくれつてんしょう	炸裂天昇
さけ	叫呼
さけくら	酒楽
さけるい	酒類
さげす	蔑
さこうどぐち	酒人口
さこた	佐古田
さこんのうまのじょう	左近ノ右馬允
さごじがわ	三孤子川
さごじょう	沙悟浄
ささ	淤
ささい	些細
ささい	笹井
ささお	笹尾
ささおか	笹丘
ささぎ	大角豆
ささぎばし	大角豆橋
ささや	囁
さしき	佐敷
さしだる	指樽
さしつか	指支
さしむ	差向
さしゅうごう	差集合
さじたりあす	天魔穹
さすかわはし	指川橋
さすけ	佐助
さすら	流離
さすらい	漂泊
さたけ	佐竹
さたん	魔人
さだ	定
さだあきら	貞明
さだしま	佐田島
さだそうぞく	サダソウ属
さだめ	運命
さだめや	運命屋
さちこ	サチ子
さちゅうじ	左黜児
さっ	察
さっかーだいかんみんこくだいひょう	サッカー大韓民国代表
さっきょう	札響
さったとうげ	薩埵峠
さっぽろ	札幌
さつき	皐月
さつきかい	皐月会
さつきさい	皐槻祭
さつきしょう	皐月賞
さつしん	殺身
さつじんじっけん	殺人実験
さつりく	殺戮
さて	扨
さていしたちょうせんごひょうじゅんごしゅう	査定した朝鮮語標準語集
さてむご	サテム語
さと	悟
さとう	佐藤
さとうすい	砂糖水
さとうひでのぶ	佐藤英信
さとこ	里子
さとだいり	里内裏
さとのね	郷の音
さとびことば	俚び言葉
さとみ	沙都美
さとむら	里村
さとり	覚
さどう	茶頭
さなえ	早苗
さなぎ	佐奈伎
さなご	さな粉
さにわ	審神者
さののおとがみのおとめ	狭野弟上娘子
さはら	佐原
さはり	砂張
さばいばー	生存者
さばか	然許
さひょうえのかみ	左兵衛督
さびがわ	蛇尾川
さぶじゃやま	三方沢山
さぶましんわん	サブマシン腕
さぶろう	三郎
さべつようご	差別用語
さほがわ	佐保川
さほびこ	沙本毘古
さほびめ	沙本毘売
さぼう	謀詐
さぼてん	覇王樹
さま	状
さまた	妨
さまたぐ	妨
さまたげ	妨
さまよい	彷徨い
さむ	作務
さむ	寒
さむがりや	寒がりや
さむらい	武士
さむらいえんじんすーぱーだいかいほう	サムライ炎神スーパー大開砲
さむらいがったいでぃすく	侍合体ディスク
さむらいせんこうは	侍閃光波
さめ	沙魚
さもなー	召喚術師
さもわる	湯沸
さや	清
さや	紗夜
さやうしからば	左様然者
さゆる	冴
さよ	佐用
さよきょく	小夜曲
さよこ	小夜子
さよちょう	佐用町
さらし	晒
さらしめん	晒綿
さらすのほうほう	サラスの方法
さらまんだー	火竜
さらまんだーきみたけ	サラマンダー公威
さりちるさんめちる	サリチル酸メチル
さる	沙流
さる	猴
さるおりがみ	猿折神
さるがわ	沙流川
さるしゅりけん	猿手裏剣
さるたびこのかみ	猿田毘古神
さるでぃすく	猿ディスク
さるとびさすけ	猿飛佐助
さるべーじ	水難救済会
さるまわし	猿回し
さろう	砂朧
さろうかく	砂楼閣
さわいり	沢入
さわき	沢木
さわぐち	沢口
さわべ	澤部
さわむら	沢村
さわらじま	椹島
さわらび	早蕨
さわらびてんじ	早蕨典侍
さわらびのつぼね	早蕨局
さん	三
さん	山
さん	散
さん	繖
さんえん	三厭
さんか	惨禍
さんかがく	産科学
さんかくがさ	三角笠
さんかくざ	さんかく座
さんかちょう	三ヶ町
さんがつどう	三月堂
さんきがっそうおんげき	三鬼合奏音撃
さんぎょうい	産業医
さんぎょうかくめい	産業革命
さんぎょうどうぶつ	産業動物
さんぐうてつどう	参宮鉄道
さんぐおびん	三果氷
さんけんじゃ	三賢者
さんけんぶんりつ	三権分立
さんげ	散華
さんげはんこんとう	散華斑痕刀
さんげん	三弦
さんこうばし	三光橋
さんご	珊瑚
さんごびんぐぁ	三合瓶小
さんごん	三献
さんさげき	三叉戟
さんさんざん	三算参
さんしょう	三性
さんしょううお	鯢
さんしょううお	鯢魚
さんしん	三線
さんじっしんほう	三十進法
さんじゅ	傘寿
さんじゅうかげきほう	三重渦撃砲
さんじゅうさんが	三十三荷
さんじゅうふりそで	三十振袖
さんじゅつすうれつ	算術数列
さんじん	三心
さんじん	三身
さんじん	山神
さんじんそう	三刃槍
さんすあびん	三色氷
さんずん	三寸
さんせい	賛成
さんぜん	燦然
さんぜんだいせんせかい	三千大千世界
さんそ	山鼠
さんそう	散相
さんそうどおり	山荘通
さんぞうほうし	三蔵法師
さんた	三太
さんだいあそうぎこう	三大阿僧祇劫
さんだいにんれつざん	三代忍烈斬
さんだつ	簒奪
さんちゃお	三貂角
さんどがさ	三度笠
さんのう	山王
さんのういっちょうめ	山王一丁目
さんのうこうえんまえ	山王公園前
さんのうこうがわとがさわらげんしりん	三ノ公川トガサワラ原始林
さんのかや	三ノ萱
さんのむら	三ノ村
さんばし	桟橋
さんばっしゅまじんだん	サンバッシュ魔人団
さんばら	三荊
さんへいほうのていり	三平方の定理
さんぽうこうじん	三宝荒神
さんぽうだいしゅりけん	三方大手裏剣
さんまい	三昧
さんまいかん	三枚冠
さんやそう	山野草
さんゆこく	産油国
さんようてつどう	山陽鉄道
さんらんしょう	産卵床
さんりづかとうそう	三里塚闘争
さんりゅうせい	三龍星
さゔぁいゔぁー	生存者
さゔぁんしょうこうぐん	サヴァン症候群
さー	卿
さーかす	曲馬団
さーが	茶川
さーばんと	召使い
さーびすざんぎょう	サービス残業
さーんうー	珊瑚
ざいけいほうていしゅぎ	罪刑法定主義
ざいたくしけんかんさつ	在宅試験観察
ざいとくかい	在特会
ざいまじょう	在間城
ざくろ	石榴
ざそなえず	座備図
ざっし	雑誌
ざつぱく	雑駁
ざつわ	雜話
ざとう	座頭
ざとうのらい	座頭の來
ざわめし	沢芽市
ざんぎりあたま	散切頭
ざんげきけん	斬撃剣
ざんげきむそうけん	斬撃無双剣
ざんげつ	斬月
ざんげん	讒言
ざんさ	斬砂
ざんざらがさ	ざんざら笠
ざんざんせいばーぎり	斬斬セイバー斬り
ざんし	残滓
ざんしょ	残暑
ざんじゃ	讒邪
ざんそ	讒訴
ざんぞうこうか	残像効果
ざんだーばーとう	ザンダーバー刀
ざんねん	殘念
ざんまだん	斬魔弾
ざんようけん	斬妖剣
ざんりゅうじん	斬龍刃
しあわせ	幸福
しあん	思案
しあん	紫杏
しい	虐
しいな	椎名
しいれたな	仕入店
しうかん	週間
しぇふぁびん	雪花氷
しぇめんぴん	雪綿氷
しぇんしぇい	先生
しえ	紫衣
しえいじべん	伺嬰児便
しえきけん	使役犬
しえん	紫艶
しおたれ	塩垂
しおてんしりえる	塩天使リエル
しおどめ	汐留
しおのえちょうやすはらかみひがし	塩江町安原上東
しおのちょうじ	塩の長司
しおのちょうじろう	塩の長次郎
しおのは	入之波
しおばる	塩原
しおひ	潮干
しおふき	塩吹
しおり	栞
しおん	紫苑
しか	併
しか	否
しか	然
しか	翅果
しか	而
しか	近
しかえいせいし	歯科衛生士
しかく	資格
しかくすう	四角数
しかけ	仕掛
しかのしまししょ	志賀島支所漢字
しかのみならず	加之
しかばね	屍
しかりべつがわ	然別川
しがちょふじけん	シガチョフ事件
しき	四季
しき	師木
しき	志幾
しき	敷
しき	頻
しきいんりょう	職員令
しきか	敷処
しきがみ	式神
しきけん	識見
しきさい	色彩
しきしま	師木島
しきしまろう	敷島樓
しきじょう	式正
しきつひこたまてみのみこと	師木津日子玉手見命
しきつひこたまでみのみこと	師木津日子玉手見命
しきみがはら	樒原
しきみやま	樒山
しきょうどう	四交道
しきりばな	仕切花
しきん	子勤
しきんこうころ	紫金紅葫蘆
しぎ	思議
しぎゃく	弑逆
しぎるむす	封緘師
しくんし	四君子
しけいかい	紫蛍会
しけむ	壽限無
しけんぶんりつ	四権分立
しげ	重
しげき	紫激気
しげぞう	茂造
しげとみいちがんぼう	重富一眼坊
しげん	士元
しげん	資源
しげんきん	始原菌
しこ	醜
しこう	思考
しこう	而
しこうてい	始皇帝
しころ	錣
しごう	諡号
しごき	縧子
しごく	至極
しさい	仔細
しし	士師
しし	孜々
しし	猪鹿
ししおう	獅子王
ししおりがみ	獅子折神
ししかえんこう	獅子火炎吼
ししかえんこう	獅子火炎哮
ししく	獅子吼
ししくら	宍倉
ししこう	獅子吼
ししこんぼう	獅子棍棒
ししすべり	獅子滑り
ししつ	脂質
ししでぃすく	獅子ディスク
ししにく	宍肉
ししのしん	獅子之進
ししのそうこう	獅子の装光
ししほうこうは	獅子咆哮波
ししもとはちろう	四至本八郎
ししゅ	四修
ししゅう	刺繡
ししゅんきしょうこうぐん	思春期症候群
ししょう	詞章
ししよう	駟子陽
ししん	私心
しじ	榻
しじま	静寂
しじむ	志自牟
しじゅんたいさい	四旬大斎
しじょう	紫仗
しじょうげんりしゅぎ	市場原理主義
しじん	詩人
しじんそうおう	四神相応
しすいかん	汜水関
しすうかんすうてきせいちょう	指数関数的成長
しず	徐
しず	静
しずおかけんりつちゅうおうとしょかん	静岡県立中央図書館
しずか	静
しずか	静香
しずくがおか	雫が丘
しずこ	静子
しずのうら	静之浦
しずのおだまき	三五郎物語
しずのおだまき	倭文麻環
しずみぐさ	沈み草
しせい	至誠
しせいがったい	四星合体
しせいじゅう	四聖獣
しせいそくだつ	至誠惻怛
しせいほるもん	雌性ホルモン
しせん	子瞻
しせんきゅうり	四川胡瓜
しぜん	自然
しぜんしゃ	至善者
しぜんじん	自然人
しそう	志操
しそちょう	紫蘇町
しそん	子孫
しそん	至尊
した	下
した	親
したが	循
したがさね	下襲
したがつ	従
したがつ	随
したがわ	服従
したすだれ	下簾
したやく	属吏
したる	志多留
したんこく	泗潭国
しだ	枝垂
しだい	次第
しだい	私大
しだおう	獅駝王
しだこく	獅駝国
しちぐてん	七紅天
しちせいがったい	七星合体
しちせいけん	七星剣
しちせいこうはしゅりけん	七星光波手裏剣
しちそうおう	四地相応
しちてんばっとう	七転八刀
しちゅう	至忠
しちよう	紙帳
しちろう	七郎
しっきゃく	疾脚
しっくない	四苦無
しっこう	疾行
しっこく	桎梏
しっこくほう	漆黒咆
しっそうせん	疾走線
しった	叱咤
しったげきれい	叱咤激励
しっと	嫉妬
しっぷう	疾風
しっぷういちじん	疾風一陣
しっぷうけんぶ	疾風剣舞
しっぷうこうはきゃく	疾風光波脚
しっぷうごうかいおとし	疾風豪快落とし
しっぷうざん	疾風斬
しっぷうざんき	疾風斬鬼
しっぷうしゅうげき	疾風蹴撃
しっぷうだん	疾風断
しっぽう	七宝
しつじょう	執杖
しつぴつ	執筆
しつよう	執拗
しづ	鎭
してい	姉弟
してい	子弟
しでん	紫電
しとうず	襪
しとく	至徳
しとり	倭文
しどう	四道
しどう	椎堂
しどう	紫藤
しどういん	士導院
しな	支那
しな	科
しなが	科長
しながら	品柄
しながわかちしんしゅくかしゅくさいきょじょう	品川歩行新宿加宿裁許状
しながわく	品川区
しなじん	支那人
しなていこく	支那帝国
しにがみあるいはしちにんみさき	死神或いは七人みさき
しにょう	屎尿
しねん	熾燃
しねんじゅう	四念住
しの	偲
しののめ	東雲
しののめゆ	東雲湯
しのはら	篠原
しのび	志能便
しのびうま	忍馬
しのびしょうへい	忍び招聘
しのびのまき	忍之巻
しのびろーぷ	忍ロープ
しのやがわ	篠谷川
しのやま	篠山
しはくし	淄博市
しばえもんだぬき	芝右衛門狸
しばかきのみや	柴垣宮
しばざかな	芝肴
しばしば	屢屢
しばしば	數々
しばぜんこう	芝全交
しばたはかせ	柴田博士
しばらくのあいだ	頃之
しびあ	希薇婭
しびとはかせ	死人博士
しびゅら	巫女
しぶ	歯部
しぶ	矢部
しぶ	示部
しぶ	至部
しぶ	豕部
しぶやべん	渋谷弁
しべん	伺便
しほう	仕法
しほう	子方
しほうしょうしょ	祠部尚書
しほうよくせい	司法抑制
しぼお	柴尾
しぼかわ	子母河
しま	仕舞
しま	州
しま	礼文
しま	縞
しまい	姉妹
しまいとし	姉妹都市
しまき	島木
しまこ	志麻子
しまだい	嶋台
しまづじっしんこう	島津日新公
しまふるく	島古来
しまりかた	締方
しまんちゅ	島人
しみず	泉
しみず	清水
しみずがおか	清水丘
しみずがわ	清水川
しみづ	清水
しみん	市民
しむちょん	沈清
しめ	示
しめいてはい	指名手配
しめがためようきかい	締固め用機械
しめさす	注連指
しめんそか	四面楚歌
しも	下
しもあかんまち	下赤間町
しもかわばたまち	下川端町
しもこやままち	下小山町
しもごふくまち	下呉服町
しもさむくら	下寒倉
しもずしまち	下厨子町
しもたてえびすじんじゃ	下竪恵比須神社
しもだいらけいこ	下平京子
しもだんじり	下地車
しもつつみ	下堤
しもつふさ	之毛豆不佐
しもて	下手
しもてんやまち	下店屋町
しもべ	僕
しもやまと	下山門
しもよこまち	下横町
しもん	諮問
しもんず	紫者達
しゃ	洒落
しゃおしょう	沙和尚
しゃおれい	暁蕾
しゃかいかきょういく	社会科教育
しゃかいかくめいとう	社会革命党
しゃかいこうがっか	社会工学科
しゃかいじゆうしゅぎ	社会自由主義
しゃかいじゆうとう	社会自由党
しゃかいびょうしつ	社会病質
しゃかいふくしがくぶ	社会福祉学部
しゃかいふくむよういん	社会服務要員
しゃかとう	釈迦頭
しゃかにょらい	釈迦如来
しゃかむにぶつ	釈迦牟尼仏
しゃく	笏
しゃくしょう	爵賞
しゃくじょう	錫杖
しゃくじょうこすいそう	錫杖湖水荘
しゃくぜつにち	赤舌日
しゃくそく	尺側
しゃくだい	釈台
しゃくねつのしし	灼熱の獅子
しゃぐま	赤熊
しゃけん	煮繭
しゃこ	硨磲
しゃしんびじゅつぶ	写真美術部
しゃだつ	洒脱
しゃちこく	車遅国
しゃっこう	赤口
しゃとー	城館
しゃどう	影
しゃどーまん	影の男
しゃないしつぎょう	社内失業
しゃなおう	遮那王
しゃぶ	車部
しゃぼん	石鹸
しゃれん	炙臠
しゃんとうろん	双頭龍
しゃんろん	翔龍
しゃんろんくらいしす	翔龍クライシス
しゃー	皇帝
しゃーくすいせいとう	赫悪彗星刀
しやう	生
しやうぎ	娼妓
しやくようにん	借用人
しやべつ	差別
しゅ	主
しゅ	種
しゅ	鴸
しゅいじょう	思惟杖
しゅいんみん	綫麵
しゅうう	驟雨
しゅうえい	秀英
しゅうえん	終焉
しゅうきゅう	綉毬
しゅうきょう	宗教
しゅうきょうばんぐみ	宗教番組
しゅうきょく	褶曲
しゅうきょくにんしゅりけん	終極忍シュリケン
しゅうぎょく	秋玉
しゅうし	舟志
しゅうしゃく	襲爵
しゅうしょうざん	修昌山
しゅうしょくご	修飾語
しゅうしょくごく	修飾語句
しゅうしんせいじょう	終身聖情
しゅうじぎほう	修辞技法
しゅうじしょうげんぎょう	種子生現行
しゅうじしょうしゅうじ	種子生種子
しゅうじゅうい	修習位
しゅうだん	集団
しゅうちしん	羞恥心
しゅうと	舅
しゅうとく	修徳
しゅうとくいんしゃくしょうゆう	修讀院釋清優
しゅうにい	秀兄
しゅうぶ	舟部
しゅうゆ	終油
しゅうれんじょう	修練場
しゅうろう	醜陋
しゅえん	朱厭
しゅか	朱伽
しゅかい	首魁
しゅがい	酒害
しゅがいしゃ	酒害者
しゅきょう	首矯
しゅくぁんこんちょん	曙光工程
しゅくしゃくしゅくしょうにんしゅりけん	縮尺縮小忍シュリケン
しゅけんこっかたいせい	主権国家体制
しゅこう	繻公
しゅこう	首肯
しゅごうけ	守護請
しゅごしき	守護職
しゅごにんぶぎょう	守護人奉行
しゅさい	酒債
しゅし	朱子
しゅしゅ	守株
しゅしゅたいと	守株待兔
しゅしん	主神
しゅじょう	主上
しゅじょう	衆生世間
しゅす	襦子
しゅせきふじん	主席夫人
しゅそ	首座
しゅっさんなんみん	出産難民
しゅっせけん	出世間
しゅっぱん	出版
しゅっぱんぶつ	出版物
しゅつどーん	出動ーン
しゅてんどうじ	酒呑童子
しゅとけん	首都圏
しゅとけんほうげん	首都圏方言
しゅはい	酒盃
しゅはり	守破離
しゅぶ	首部
しゅへい	珠柄
しゅぼう	首防
しゅみせん	須弥山
しゅむしゅ	占守
しゅもくちょう	撞木町
しゅらだま	修羅霊
しゅらひゃっきけん	修羅百鬼剣
しゅり	朱里
しゅりけんざん	手裏剣斬
しゅりょうめんじょう	狩猟免状
しゅりん	珠麟
しゅるいさいけん	種類債権
しゅんきょう	春嬌
しゅんぎょう	春曉
しゅんしゅんだん	瞬瞬弾
しゅんしゅんりっか	盾舜六花
しゅんせつ	浚渫
しゅんまく	瞬膜
しゅんみん	春眠
しゆう	蚩尤
しゆういっつい	雌雄一対
しゆうけん	私有権
しゆうし	讐視
しゆうそふとうぇあ	私有ソフトウェア
しゆうに	蚩尤弐
しゆうりよう	収領
しゆうれん	聚斂
しゆこう	趣向
しゆしよ	手書
しゆじん	主人
しゆつげん	出現
しゆつぱん	出版
しゆんかん	瞬間
しょ	暑
しょう	向
しょう	相
しょう	翔
しょう	鍾
しょうあん	正安
しょういかい	摂衣界
しょういつめいい	正一盟威
しょうう	蕭瑀
しょうおう	正応
しょうおんじ	松音寺
しょうか	正嘉
しょうかい	哨戒
しょうかこうそ	消化酵素
しょうがい	渉外
しょうきょう	正慶
しょうきょう	正橋
しょうきょくひ	称極碑
しょうきん	償金
しょうぎかい	将棋界
しょうぎのせんぽう	将棋の戦法
しょうぐんひょう	将軍標
しょうけいえいか	小軽鋭化
しょうけつ	猖獗
しょうけんこうごう	昭憲皇后
しょうけんこうたいごう	昭憲皇太后
しょうげきばくれつざん	衝撃爆裂斬
しょうげん	正元
しょうこ	掌故
しょうこのゆうえつ	証拠の優越
しょうごいんきゅうり	聖護院胡瓜
しょうごん	精勤
しょうごん	荘厳
しょうさい	小菜
しょうざん	沼山
しょうざんちょもんきしゅう	想山著聞奇集
しょうしゃ	瀟洒
しょうしゃく	陞爵
しょうしょうけん	昇昇拳
しょうしょうざん	翔翔斬
しょうしょうまい	昇昇舞
しょうしんぼう	正真坊
しょうじ	正治
しょうじ	生死
しょうじきかい	摂食界
しょうじこ	精進湖
しょうじるてん	生死流転
しょうじん	精進
しょうすう	小数
しょうすうてん	小数点
しょうせいおう	証聖王
しょうそう	焼相
しょうそうかい	摂僧界
しょうたい	招待
しょうたい	昌泰
しょうたいせん	照胎泉
しょうたいむ	照時間
しょうだいじょうろん	摂大乗論
しょうちゅう	正中
しょうちゅう	焼酎
しょうちょう	正長
しょうてきあん	松滴庵
しょうてんがい	商店街
しょうてんき	小天鬼
しょうとうう	小桃塢
しょうとく	証得
しょうとくりょうじゅせいこじ	照徳嶺樹清居士
しょうどう	正堂
しょうどう	正童
しょうな	庄名
しょうねん	少年
しょうのたろうにゅうどう	庄野ノ太郎入道
しょうは	翔破
しょうばん	鐘板
しょうひじんたい	脛腓靱帯
しょうひぜい	消費税
しょうふうえんりょくち	松風園緑地
しょうぶくき	菖蒲久喜
しょうへい	招聘
しょうへいにじゅういちねんめいぼんじいたび	正平廿一年銘梵字板碑
しょうへき	墻壁
しょうべえ	庄兵衛
しょうほう	正保
しょうもん	上聞
しょうもん	閶門
しょうもんがわ	将門川
しょうや	翔哉
しょうらいあん	松籟庵
しょうりゃく	正暦
しょうりゅうばくざんとう	昇竜抜山刀
しょうりゅうびゃくうじん	小龍白羽陣
しょうりょううま	精霊馬
しょうりょうばな	精霊花
しょうるいあわれみのれい	生類憐れみの令
しょうれんげ	青蓮華
しょうろう	檣楼
しょうわ	昭和
しょうわ	正和
しょうわじだい	昭和時代
しょか	書架
しょぎょう	所業
しょく	寔
しょく	職
しょくぎょうしょうかいじぎょう	職業紹介事業
しょくぎょうちゅうかいじぎょう	職業仲介事業
しょくじ	食事
しょくだましい	喰魂
しょくどうえん	食道園
しょくばけんがく	職場見学
しょくばほうもん	職場訪問
しょくひんかがく	食品科学
しょくぶ	色部
しょくぶ	食部
しょくぶつせい	植物性
しょくもつせんい	食物繊維
しょくゆう	贖有
しょけい	処刑
しょげい	書芸
しょさいいん	初斎院
しょしひゃっか	諸子百家
しょしょ	處處
しょずり	初刷
しょだな	書棚
しょっかーだいしゅりょう	ショッカー大首領
しょっく	衝撃
しょとうきょういく	初等教育
しょはん	初版
しょひょう	書評
しょぶ	黍部
しょぶん	処分
しょめい	署名
しょろう	書樓
しよう	稱
しよう	章
しようどう	聳動
しようねんしてい	少年子弟
しようねんじだい	少年時代
しようばい	商賣
しよくもつ	食物
しよせい	書生
しよりん	書林
しらい	白井
しらかね	白銀
しらかのおおやまとねこのみこと	白髪大倭根子命
しらかのおほやまとねこのみこと	白髪大倭根子命
しらかみ	白上
しらかわ	白川
しらかわ	白河
しらがね	白銀
しらこ	白子
しらすず	白鈴
しらずもり	不知森
しらずもりじんじゃ	不知森神社
しらずやぶ	不知藪
しらずやわたのもり	不知八幡森
しらたま	白玉
しらとりのじゅん	白鳥のジュン
しらぬい	不知火
しらぬいてっしん	不知火鉄心
しらのはま	白良浜
しらゆき	白雪
しり	臀
しりげんしゅ	尻原種
しりぞ	擯
しりつだいがく	市立大学
しりつだいがく	私立大学
しりつてんじゅこうとうがっこう	私立天樹高等学校
しりょう	思量
しりょうい	資糧位
しりよく	視力
しる	勒
しる	汁
しる	記
しるくはっと	絹帽
しるし	天象
しるばー	銀色
しるばーないと	白銀騎士
しるふぃーど	西風の妖精
しるもの	汁物
しれいくわん	司令官
しれつ	熾烈
しれとこ	知床
しろ	代
しろ	城
しろ	白
しろう	史郎
しろう	死郎
しろがね	白金
しろがね	白銀
しろがね	銀
しろく	白孔
しろくび	白首
しろそこひ	白底翳
しろたへ	白妙
しろたへ	白栲
しろねりおおざる	白練大猿
しろめ	白鑞
しろわのかんまき	白輪官牧
しわ	皺
しん	信
しん	真
しん	神
しん	身
しんあん	新案
しんい	辛夷
しんいせいはいとう	辛夷清肺湯
しんいち	真一
しんえいたい	親衛隊
しんえねるぎー	新エネルギー
しんおうまこうりんれき	真逢魔降臨暦
しんかいぎょじんでずる	深海魚人デズル
しんかうろう	新幸樓
しんかしゃ	新華社
しんかしゃつうしん	新華社通信
しんかじゅう	進化獣
しんかつうじんしゃ	新華通訊社
しんかりゅうはざん	神火龍破斬
しんかん	新刊
しんかんさい	新勧祭
しんかんせん	新幹線
しんがくぶ	神学部
しんがり	殿
しんき	神器
しんきたまち	新北町
しんきち	新吉
しんぎ	真木
しんぎゅらりてぃ	特異点
しんぎょうとうりゅう	心形唐流
しんけいげんしゅ	神経原種
しんけいはったつしょうがいぐん	神経発達障害群
しんけいはったつしょうぐん	神経発達症群
しんけんしょうぶ	真剣翔舞
しんけんまるすいりゅうつちけむりのまい	シンケンマル水流土煙りの舞い
しんけんまるてんちのまい	シンケンマル天地の舞い
しんけんまるよんれんぎり	シンケンマル四連斬り
しんげつ	震月
しんげつざんぱ	新月斬波
しんこう	侵攻
しんこう	針口
しんこうさい	神幸祭
しんこうしゅうきょう	新興宗教
しんこしょてん	新古書店
しんこりゅう	真古流
しんこん	神魂
しんさく	振作
しんさく	新作
しんさむらいがったいでぃすく	真侍合体ディスク
しんざ	新佐
しんざら	心皿
しんし	真摯
しんし	辛巳
しんしつさいどう	心室細動
しんしゃく	斟酌
しんしゅうきょう	新宗教
しんしゅきょうかいちょう	神主教会長
しんしんだ	伸伸打
しんじいけ	心字池
しんじつ	眞實
しんじつ	真実
しんじつのみち	真実の光
しんじゅうあらがみけん	神獣荒神剣
しんじゅうげきぼう	新獣撃棒
しんじゆうしゅぎ	新自由主義
しんじょうかずま	新城十馬
しんじょうじ	真成寺
しんじん	真人
しんじん	神人
しんじんぞく	神人族
しんすず	神鈴
しんせいがったい	新星合体
しんせいきょうだん	真聖教団
しんせいじすくりーにんぐ	新生児スクリーニング
しんせいじますすくりーにんぐ	新生児マススクリーニング
しんせかい	新世界
しんせん	新撰
しんせん	神仙
しんぜんしき	神前式
しんぜんとし	親善都市
しんそうたんせい	身相端正
しんそうほんぶ	神総本部
しんそく	神息
しんそくざんぞう	神速残像
しんぞう	梳攏
しんぞうげんしゅ	心臓原種
しんたじまばしひがし	新田島橋東
しんたね	新種
しんたろう	真太郎
しんたん	薪炭
しんだい	寝台
しんちゅう	真鍮
しんちょうは	慎重派
しんちんてつ	神珍鉄
しんでん	新田
しんとうめっきゃく	心刀滅却
しんどう	進藤
しんどうし	新童子
しんなり	真形
しんにち	親日
しんのう	親王
しんぱん	親藩
しんふぉにー	交響曲
しんぶ	神撫
しんぶ	臣部
しんぶ	身部
しんぶ	辛部
しんぶ	辰部
しんぶぶんしゅうごう	真部分集合
しんぶん	新聞
しんぷう	神風
しんぽ	進歩
しんまのかた	新間の方
しんまん	新マン
しんめい	新名
しんめつじゅうしんがろ	心滅獣身ガロ
しんめつじゅうしんぜろ	心滅獣身絶狼
しんめつりゅうぜろ	心滅竜絶狼
しんもじ	新文字
しんらつ	辛辣
しんらばんしょうざん	森羅万象斬
しんりがく	心理学
しんりけんさ	心理検査
しんりゃく	侵略
しんりゃくのその	侵略の園
しんりょうか	診療科
しんれい	振鈴
しんれい	浸礼
しんれいしゃしん	心霊写真
しんろく	信六
しんわいん	真輪院
しーあん	西安
しーざー	該撤
しーざーあんこくじゃばくげき	シーザー暗黒邪縛撃
しーそーぎり	シーソー斬り
しーぷ	門番
じあん	治安
じうんいんでんおうきゅうてっしんこじ	慈雲院殿應救哲心居士
じぇろ	ジェロ
じぇろのいいうたやまもり	ジェロのいい歌山もり
じぇんだーふびょうどうしすう	ジェンダー不平等指数
じかんけいさつ	時間警察
じかんへんげ	時間変化
じがたもんじょ	地方文書
じきかいろ	磁気回路
じきかえん	食香烟
じきかたん	食火炭
じきけつ	食血
じきしょうに	食小児
じきすい	食水
じきた	食唾
じきたいこう	慈禧太后
じきと	食吐
じきとつ	直裰
じきどう	食堂
じきどく	食毒
じきにく	食肉
じきにんしょうき	食人精気
じきばん	食鬘
じきふう	食風
じきふじょうしきてつどう	磁気浮上式鉄道
じきふん	食糞
じきほう	食法
じきん	持禁
じぎょう	地行
じぎょうはま	地行浜
じぎょうりえき	事業利益
じくうけん	時空剣
じくじ	忸怩
じげ	地下
じげむ	壽限無
じげむじげむ	寿限無寿限無
じげんじゅう	次元獣
じげんだいし	慈眼大師
じげんむし	次元虫
じこあいせいぱーそなりてぃしょうがい	自己愛性パーソナリティ障害
じこうしんくうにんれつざん	磁光真空忍烈斬
じこくけんかいじ	時国剣界時
じこしほんりえきりつ	自己資本利益率
じこひひょうばんぐみ	自己批評番組
じごくせいじん	地獄星人
じごくのよんじゅうし	地獄の四獣士
じさ	時差
じしゅ	自首
じしゅうりん	時習鈴
じしょう	事象
じしょう	治承
じしょうのちへいせん	事象の地平線
じしょうのちへいめん	事象の地平面
じしん	侍真
じじぬき	ジジ抜き
じじょ	侍女
じじょう	治定
じじょのやしろ	爾女の社
じじょのやしろ	爾汝の社
じせい	自制
じぜんめんせつ	事前面接
じぜんめんだん	事前面談
じぞくかのうなかいはつもくひょう	持続可能な開発目標
じっけ	食気
じっしのそ	十思之疏
じっしんほう	十進法
じっすうがた	実数型
じった	十太
じったいかんれんもでる	実体関連モデル
じっちゅうぎ	十柱戯
じっていっちょくせん	十手一直線
じつ	実
じつくうかんほう	実空間法
じつけん	実験
じつげつ	日月
じつごと	実事
じつりえき	実利益
じてん	自転
じでん	神田
じどう	児童
じどうしゃ	自動車
じどうぶんがく	児童文学
じばなし	地噺
じばんぷろじぇくと	ジバン計画
じひつ	自筆
じふにかい	凌雲閣
じぶ	而部
じぶ	耳部
じぶ	自部
じぶきょう	治部卿
じみーなかた	ジミー中田
じむろーとれいきゃくき	ジムロート冷却器
じめい	慈明
じもく	耳目
じもつ	持物
じゃいあんつ	巨人
じゃいあんときりんぐ	最強喰いの
じゃおだんじぃ	攪拌槽
じゃかんれいきゃくき	蛇管冷却器
じゃぎ	邪義
じゃくまく	寂蒔
じゃこう	邪甲
じゃこう	麝香
じゃこうけん	邪甲剣
じゃこうじんくわがたいたん	邪甲神クワガタイタン
じゃこうねこ	麝香猫
じゃこつきしぎる	邪骨騎士義流
じゃこん	蛇根
じゃしん	邪神
じゃしんけん	蛇心剣
じゃしんごうてんへん	邪身豪天変
じゃしんりゅう	蛇心流
じゃたん	蛇胆
じゃだんほうじんすてまおつ	邪団法人ステマ乙
じゃっこう	若高
じゃていいりえす	邪帝イリエス
じゃでんせんたいねじれんじゃー	邪電戦隊ネジレンジャー
じゃばんざん	蛇盤山
じゃび	邪美
じゃむ	邪武
じゃめいしんでずもぞーりゃ	邪命神デズモゾーリャ
じゃれいきでぃーなす	邪霊姫ディーナス
じゃーまんうぃーど	ドイツの雑草
じやうい	情意
じやうはんぶ	上半部
じやうぶ	上部
じやま	邪魔
じゅうおうけん	獣皇剣
じゅうかいしょ	住海渚
じゅうかいっせん	獣火一閃
じゅうきし	重騎士
じゅうきたんちけん	銃器探知犬
じゅうくうがったい	獣空合体
じゅうけん	重剣
じゅうげきは	獣撃破
じゅうげきぼう	獣撃棒
じゅうげんりゅうえいえいとう	獣源流鋭鋭刀
じゅうこう	重甲
じゅうこうきち	重甲基地
じゅうこうきでん	重甲気殿
じゅうごや	十五夜
じゅうさん	十三
じゅうさんや	十三夜
じゅうしんきしぎが	獣身騎士戯牙
じゅうしんちょう	獣心町
じゅうじやいばのじゅつ	十字刃の術
じゅうじゅうぜんしんへん	獣獣全身変
じゅうじん	獣人
じゅうじんじゃしんへん	獣人邪身変
じゅうじんぞく	獣人族
じゅうそうけん	獣奏剣
じゅうそうこうぎんがまん	獣装光ギンガマン
じゅうそうこうりん	獣装光輪
じゅうそうのつめ	獣装の爪
じゅうそうば	獣走馬
じゅうそうぼうぐ	獣装防具
じゅうそうりんぐ	獣装輪具
じゅうぞう	重蔵
じゅうぞくへんすう	従属変数
じゅうたんばくげき	絨毯爆撃
じゅうだいじゅうでんりゅう	十大獣電竜
じゅうだんしゃくこぼるだ	獣男爵コボルダ
じゅうちょうかんじきねつかいど	住塚間食熱灰土
じゅうていだいじゅうじん	獣帝大獣神
じゅうでんりゅう	獣電竜
じゅうとうさんばっしゅ	銃頭サンバッシュ
じゅうにおりがみだいさむらいぎり	十二折神大侍斬り
じゅうにぶんのご	十二分の五
じゅうねんき	十年紀
じゅうのう	十能
じゅうふじょうこうはく	住不浄巷陌
じゅうぶ	禸部
じゅうべるちゅうし	獣ベル虫市
じゅうほう	銃砲
じゅうまおうごるもあ	獣魔王ゴルモア
じゅうようじんぶつ	重要人物
じゅうらい	従来
じゅうりくがったい	獣陸合体
じゅうりょうあげ	重量挙げ
じゅうりょく	重力
じゅうりん	蹂躙
じゅうりん	蹂躪
じゅうれつどくげきほうだん	縦列毒撃砲弾
じゅうろうがわ	十郎川
じゅうろくちょう	拾六町
じゅうろくちょうだんち	拾六町団地
じゅえい	寿永
じゅえんど	呪煙吐
じゅきょう	入興
じゅぐ	呪具
じゅげたら	寿限垂
じゅごん	呪禁
じゅごんし	呪禁師
じゅごんはかせ	呪禁博士
じゅしぴえーる	呪士ピエール
じゅしゃく	授爵
じゅしん	受浸
じゅじゅつじゅず	呪術数珠
じゅせん	受洗
じゅだく	受諾
じゅちゅうじゅう	樹中住
じゅつごろんり	述語論理
じゅつだましい	術魂
じゅもつ	咒物
じゅらき	侏羅紀
じゅり	寿里
じゅりせん	呪裏扇
じゅりょく	咒力
じゅん	純
じゅんかつ	潤滑
じゅんかんしょうすう	循環小数
じゅんこうろかい	蓴羹鱸膾
じゅんこめ	純米
じゅんた	順太
じゅんぶっしつ	純物質
じゅんぷうじ	順風耳
じゅんぺい	潤平
じゅんほうがく	純邦楽
じゅんめいのたき	巡命の滝
じゅんりえき	純利益
じゆ	寿
じゆいをん	受伊翁
じゆうきたちょうせんほうそう	自由北朝鮮放送
じゆうぜん	従前
じゆうでんしきんじ	自由電子近似
じゆうなん	柔軟
じゆうへんすう	自由変数
じゆきようりゆう	儒教流
じゆく	熟
じゆくどくあんしよう	熟読暗誦
じゆくどくつうらん	熟読通覧
じゆみやう	壽命
じゆんじよ	順序
じゆんぽう	遵奉
じょう	定
じょう	尉
じょう	蒸
じょうあん	承安
じょういしゅうごう	上位集合
じょうえ	浄衣
じょうえい	貞永
じょうおう	承応
じょうおう	貞応
じょうおうのげきしょう	承応の鬩牆
じょうかん	浄寛
じょうが	嫦娥
じょうがん	貞観
じょうき	蒸氣
じょうきさいじん	蒸滊済人
じょうきゅう	承久
じょうきょう	上矯
じょうきょう	貞享
じょうきん	浄巾
じょうげん	承元
じょうげん	貞元
じょうさい	城砦
じょうし	上司
じょうし	上梓
じょうしきまく	定式幕
じょうしゃ	蒸煮
じょうしょさち	成所作智
じょうしん	上神
じょうじ	貞治
じょうじゅ	成就
じょうすいどおり	浄水通
じょうせいだんち	城西団地
じょうせつ	浄刹
じょうぜつ	饒舌
じょうそ	上疏
じょうそう	常総
じょうだんししゃ	浄壇使者
じょうちゅうこく	上柱国
じょうてもの	上手物
じょうとうく	常套句
じょうとく	承徳
じょうど	浄土
じょうない	城内
じょうなんせん	城南線
じょうなんりきゅう	城南離宮
じょうぶ	上武
じょうぶ	常武
じょうべんき	襄沔記
じょうほう	承保
じょうほうか	情報化
じょうほうかしゃかい	情報化社会
じょうほうしゃかい	情報社会
じょうほうりてらしー	情報リテラシー
じょうぼう	上防
じょうぼし	上乾
じょうぼん	常盆
じょうもんじん	縄文人
じょうやま	城山
じょうゆ	上諭
じょうゆいしきろん	成唯識論
じょうようかんじ	常用漢字
じょうらく	上洛
じょうらん	擾乱
じょうりゃく	承暦
じょうりゅうしんげきは	情龍神撃破
じょうりんじ	定林寺
じょうろくぶつ	丈六仏
じょうわ	承和
じょうわ	貞和
じょおうばち	女王蜂
じょしがくせいぶ	女子学生部
じょすうし	序数詞
じょせいによるせいてきぎゃくたい	女性による性的虐待
じょせいぶ	女性部
じょせいほるもん	女性ホルモン
じょそこ	女装子
じょにえもん	丈二右衛門
じょふく	徐福
じょほうるまる	浄宝縷丸
じょろうぐも	女郎蜘蛛
じょーじあご	ジョージア語
じょーじしろがね	ジョージ白鐘
じょーずがい	縄頭蓋
じよげん	序言
じらい	爾来
じらいげき	地雷撃
じらいこく	自来国
じらいしん	地雷震
じらいや	磁雷矢
じりゃく	治暦
じれい	事例
じれったい	時劣態
じれっぱ	時裂波
じれつくうざんぱ	時裂空漸波
じれつざん	時裂斬
じろう	次狼
じろう	次郎
じろうべい	次郎兵衛
じろきち	ジロ吉
じん	幽精
じん	迅
じんあい	塵埃
じんかいしゅんじん	塵芥隼迅
じんかいせんじゅつ	塵芥旋術
じんかいめっせん	塵芥滅殲
じんかいらいごう	塵芥雷剛
じんかくけん	人格権
じんがさ	陣笠
じんぐう	神功
じんぐうこうぐう	神功皇宮
じんぐうしきねんせんぐう	神宮式年遷宮
じんぐうじ	神宮寺
じんぐる	迅愚流
じんこう	人口
じんこうせいめい	人工生命
じんこうらいはっせいそうち	人工雷発生装置
じんこうわくせい	人工惑星
じんごう	神興
じんしん	人心
じんじ	人事
じんじょうたい	腎上体
じんせい	人生
じんぜん	人前
じんぜんしき	人前式
じんぞうげんしゅ	腎臓原種
じんたいちゃくようぬいぐるみ	人体着用ぬいぐるみ
じんち	人智
じんちょうかん	神長官
じんつう	神通
じんでんちょう	神田町
じんなん	神南
じんにんじょせつ	神人序説
じんぶつ	人物
じんぶんがくぶ	人文学部
じんべんだいぼさつ	神変大菩薩
じんみん	人民
じんむこのかた	神武以来
じんめい	人名
じんよ	燼余
じんらい	迅雷
じんらいしゅうげき	迅雷蹴撃
じんらく	神楽
じんらく	秦楽
じんりんきんもうずい	人倫訓蒙図彙
じんりー	静麗
すい	吹
すい	水
すい	錐
すい	騅
すいいん	水蝹
すいうんざん	翠雲山
すいえい	水泳
すいかそうじんとう	スイカ双刃刀
すいぎょく	翠玉
すいぎんちえんかん	水銀遅延管
すいぎんちえんせん	水銀遅延線
すいこでんのせいりつし	水滸伝の成立史
すいごう	水郷
すいじゅうのもりびと	水獣の守り人
すいすい	睢水
すいせい	彗星
すいせい	水棲
すいせいけんながれ	水勢剣流水
すいそけつごうけっしょう	水素結合結晶
すいそげんし	水素原子
すいそばくだん	水素爆弾
すいぞうがん	膵臓癌
すいたくわい	吹田慈姑
すいちょくらっかしきだんがんけん	垂直落下式弾丸拳
すいは	水破
すいばく	水爆
すいばくだいかいじゅう	水爆大怪獣
すいふよう	酔芙蓉
すいぶ	隹部
すいぶん	水分
すいめいきしぜくす	翠瞑騎士ゼクス
すいもの	吸物
すいよう	水妖
すいらん	翠蘭
すいりゅうのまい	水流の舞い
すいりゅうは	水流波
すいりゅうは	水流破
すいりゅうひゃくまいおろし	水流百枚おろし
すいれん	翠蓮
すいれんどう	水簾洞
すうぇーでんこくりつぎんこう	スウェーデン国立銀行
すうぉんし	水原市
すうがくきそろん	数学基礎論
すうぎ	芻議
すうしき	数式
すうせい	趨勢
すうよう	枢要
すうようきゅうり	四葉胡瓜
すうりもでる	数理モデル
すうりょうかりろん	数量化理論
すえ	据
すえがわ	須恵川
すえたけ	末竹
すえだれ	末垂れ
すえつむはな	末摘花
すえひろ	末広
すおう	蘇芳
すかるすたー	髑髏星
すがかさ	菅笠
すがのひろふさ	菅廣房
すきぼり	鋤彫
すきまさんぎょう	隙間産業
すきましじょう	隙間市場
すきませんさー	隙間センサー
すきる	天賦
すきる	慰謝料
すきる	能力
すぎ	杉
すぎもと	杉本
すぎわい	生業
すぎわい	産業
すくちょうかみ	漉長上
すくな	寡
すくなびこなのかみ	少名毘古那神
すくもじま	粭島
すくよう	宿曜
すくようどう	宿曜道
すくわっど	特捜隊
すぐおびん	泡泡氷
すぐる	傑
すけあくろう	かかし男
すけだちでぃすく	助太刀ディスク
すけもと	祐職
すけるとんうぉりあー	骸骨戦士
すげ	菅
すげがさ	菅笠
すげのかさ	菅の笠
すこ	少
すこぶ	頗
すこらがく	スコラ学
すこんぶ	酢昆布
すごうゆうか	菅生ユウカ
すさきこうえん	須崎公園
すさきはまにし	須崎浜西
すさきまち	須崎町
すさのお	素盞嗚
すさのお	素蓋鳴
すさのおのみこと	須佐之男命
すざく	朱雀
すし	鮓
すし	鮨
すしでぃすく	寿司ディスク
すじ	捩
すじがね	筋金
すじがらのあくまろ	筋殻アクマロ
すす	前
すす	煤
すすき	薄
すすぎ	進木
すず	清
すず	錫
すず	鐸
すずかぜ	涼風
すずき	鈴木
すずこう	鈴高
すずにし	鈴西
すずのや	鈴屋
すずのやのうし	鈴屋大人
すずはく	錫箔
すずぶ	鈴部
すずみ	涼美
すずやま	錫山
すたっかーとのーと	弾ける音符
すたるひん	須田留貧
すたんぷひゃくれつおし	スタンプ百烈押し
すだ	角田
すだまりごおり	酢だまり氷
すっぽん	鼈
すつ	棄
すて	捨
すてぃぐま	聖痕
すてお	捨置
すてっき	洋杖
すてどうじ	捨童子
すてら	星
すてれおほうそう	ステレオ放送
すで	已
すで	既
すで	旣
すとらいくすまっしゅ	烈蹴撃
すとらくばりうす	スト楽バリウス
すとーん	石
すとーんごーれむ	岩石ゴーレム
すどう	須藤
すないぱー	狙撃手
すなお	愨
すなおかわち	直川智
すなはち	廼
すなほ	朴
すなわ	乃
すなわ	則
すね	脛
すねーい	行列
すのまたじょう	墨俣城
すのーみすと	白夢
すはまだい	州浜台
すば	素晴
すばな	州鼻
すばる	彗
すばる	昴
すばる	昴流
すばるがはま	昴ヶ浜
すばるぼしこうとうがっこう	昴星高等学校
すぱーくまん	電流人間
すぴりっつ	魂
すぷらいと	昴石
すぷりがん	裏解決屋
すべ	惣
すべ	都
すべか	須
すぺしゃるげきげきほう	スペシャル激激砲
すぺるどらごん	魔竜
すぺーすもんすたー	宇宙大怪獣
すぼだいそし	須菩提祖師
すみだがわはせん	隅田川派川
すみなわろうじん	墨縄老人
すみのえのなかつのきみ	墨江中王
すみむね	隅棟
すみやか	墨家
すみよし	住吉
すみよしどおり	住吉通り
すむ	棲む
すめら	天皇
すめらおおかみおんやしろ	皇大神御社
すめらおおかみやしろ	皇大神社
すめらみくに	皇御國
すめらみことのひつぎ	帝皇日継
すめらみことのふみ	天皇記
すもう	相撲
すもうぢゃや	相撲茶屋
すらむ	貧困街
すり	掏摸
すりあげど	摺揚戸
すりばち	擂鉢
すりーとっぷ	三大処女神
するが	駿河
すろうぷ	傾斜面
すろーらいふ	優雅な生活
すわ	諏訪
すわ	陬波
すわいかみすじ	仲屋上筋
すわぐすり	諏訪薬
すわっしゅばっくらー	盗剣士
すわほっしょう	諏訪法性
すわみしるしぶみ	陬波御記文
すわら	須原
すわわかひこのみこと	須波若彦命
すんけい	寸勁
すゔぁるたあーるゔ	黒エルフ
すゔぁるとあーるゔへいむ	黒エルフの国
すーぱー	超
すーぱーきりょくばずーか	スーパー気力バズーカ
すーぱーげきげきほう	スーパー激激砲
すーぱーじゃがーげき	スーパージャガー撃
すーぱーじゃがーげきすぺしゃる	スーパージャガー撃スペシャル
すーぱーたいがーげき	スーパータイガー撃
すーぱーだぶるげき	スーパーダブル撃
すーぱーちーたーげき	スーパーチーター撃
すーぱーとりぷるげき	スーパートリプル撃
すーぱーぶらざーげき	スーパーブラザー撃
すーぱーへんげ	スーパー変化
すーる	妹
すーる	姉妹
ずい	甤
ずいぎょう	随形
ずいほうびに	随方毘尼
ずげんむ	壽限無
ずげんむ	寿限無
ずこう	頭光
ずさん	杜撰
ずし	寿司
ずしまちどおり	厨子町通り
ずつきおとし	頭突き落とし
ずのうげんしゅ	頭脳原種
ずのうめいせき	頭脳明晰
ずびずばー	酢鼻酢波
ずぶう	頭部
せい	制
せい	精
せいいたいしょうぐん	征夷大将軍
せいうん	栖雲
せいうんそう	星雲荘
せいえいだいおう	聖嬰大王
せいおん	正音
せいかん	征韓
せいかん	精悍
せいかん	精管
せいかんじん	星間塵
せいかんたい	性感帯
せいかんぶっしつ	星間物質
せいかんろんじゃ	征韓論者
せいがこうしよう	正雅高尚
せいがん	青岩
せいきしき	正規式
せいきすう	正規数
せいきち	正吉
せいぎのひーろー	声技の英雄
せいけいえん	清谿園
せいげんしゅるいさいけん	制限種類債権
せいこ	星子
せいこ	省子
せいここ	聖姑姑
せいごけしゅう	西牛賀洲
せいさいかん	精細管
せいさいき	精細鬼
せいさいげん	星彩弦
せいさいせんそう	正妻戦争
せいさく	精索
せいさつよだつのけんり	生殺与奪の権利
せいさんぎじゅつ	生産技術
せいし	正視
せいし	誠之
せいしえいせい	静止衛星
せいしつ	正室
せいしゃ	斉射
せいしょくきげんしゅ	生殖器原種
せいしょくはっぽうかいじゅう	青色発泡怪獣
せいしよく	生殖
せいしんだいりんけん	星心大輪拳
せいじ	政二
せいじ	盛事
せいじ	誠司
せいじがえる	青磁蛙
せいじし	星獅子
せいじしもかぶらはないけ	青磁下蕪花生
せいじゅうけん	星獣剣
せいじゅつしんしょ	正述心緒
せいじょう	聖上
せいじん	星人
せいせい	生々
せいせいかいじゅう	棲星怪獣
せいせいばく	聖聖縛
せいそう	精巣
せいそうほう	清掃法
せいそくしき	正則式
せいそくひょうげん	正則表現
せいぞう	製造
せいたい	青黛
せいたいがったいそうち	生体合体装置
せいちゅう	掣肘
せいちん	清珍
せいてきろーるぷれい	性的ロールプレイ
せいてんたいせい	斉天大聖
せいてんま	星天馬
せいと	西都
せいとくしゅぎ	生得主義
せいとくほいくえん	成徳保育園
せいとくろん	生得論
せいどう	星洞
せいどう	聖堂
せいどうのへび	青銅の蛇
せいどく	精読
せいなう	細男
せいなんにっぽん	西南日本
せいにく	精肉
せいにほんまつ	正二品松
せいにんじゅうつばさまる	聖忍獣ツバサマル
せいねんじつぎょうか	青年実業家
せいひ	聖匙
せいひつ	聖櫃
せいひつ	静謐
せいび	聖日
せいふ	政府
せいぶ	斉部
せいぶ	青部
せいぶつ	生物
せいぶつかがくてきさんそようきゅうりょう	生物化学的酸素要求量
せいほうおう	星鳳凰
せいほうかい	青袍怪
せいほうきょうかい	西方教会
せいほうけいすう	正方形数
せいみきょく	舎密局
せいめい	星明
せいめい	生命
せいめいのき	生命の樹
せいもん	請問
せいや	晴也
せいゆ	製油
せいゆう	西幽
せいようしんじぶつ	西洋新事物
せいようじじょう	西洋事情
せいようぶんめい	西洋文明
せいようりゆう	西洋流
せいらい	生来
せいりゅう	精留
せいれき	西暦
せいれつざん	星烈斬
せいをふんでおそるるなかれ	蹈正勿懼
せいゔぁーこーど	救世候補生
せうさつし	小册子
せうせいやぶらずやはんのゆめ	鐘聲不破夜半夢
せうどくわい	小土塊
せかい	世界
せかい	即売会
せかいいさん	世界遺産
せかいくにづくし	世界国尽
せかいじく	世界軸
せかいちつじょ	世界秩序
せかいぢう	世界中
せき	関
せきか	石果
せきがいじじゅうどーど	石貝侍従ドード
せきがく	碩学
せきぐち	関口
せきぐつざん	石儡山
せきしょう	石尟
せきしょくかえんかいじゅう	赤色火焔怪獣
せきしんげつしゃ	赤新月社
せきしんしょうりんけんがっしょう	赤心少林拳合掌
せきしんしょうりんけんもろてうち	赤心少林拳諸手打
せきじゅ	赤鱬
せきじゅうじかい	赤十字会
せきじゅうじしゃ	赤十字社
せきたい	石帯
せきついげんしゅ	脊椎原種
せきね	関根
せきぶ	石部
せきぶ	赤部
せきほうかい	赤袍怪
せきりゅう	赤竜
せきりゅうそうりゅうけん	赤龍双竜剣
せきりょく	石緑
せきるい	石塁
せくしょん	地区
せけん	世間
せけんぼう	世間法
せこいあ	賢樹
せしゅう	世襲
せじん	世人
せたい	世態
せたがやく	世田谷区
せたこうさてん	瀬田交差点
せたまいもとまち	世田米本町
せっけい	切形
せっけいかささぎずかびん	雪景鵲図花瓶
せっしょう	折衝
せっしんしんこう	雪岑津興
せっつてつどう	摂津鉄道
せっとうざい	窃盗罪
せっぷ	説郛
せつ	接
せつ	説
せつか	節果
せつこ	節子
せつごうじ	接合辞
せつざん	雪山
せつしよう	殺生
せつめいへんすう	説明変数
せつるさい	截流斎
せな	背
せのけしき	背の景
せびろ	背広
せま	狭
せみ	蝉
せめ	責
せめんとどおり	セメント通り
せりふ	台詞
せるまーぐん	セルマー群
せれっそおおさか	セレッソ大阪
せん	僭
せんおうのしるべ	先王の導
せんか	扇花
せんかげき	扇火撃
せんかん	船艦
せんぎん	鮮銀
せんげつ	繊月
せんこ	仙狐
せんこうきしろーど	閃光騎士狼怒
せんこうせいじゅうけん	閃光星獣剣
せんこく	川穀
せんこつ	川骨
せんご	戦後
せんごくじだい	戦極時代
せんごくどらいばー	戦極ドライバー
せんし	睒子
せんしだん	扇四弾
せんしゅうきたまねぎ	泉州黄玉葱
せんしゅけんじゃ	選手権者
せんしょう	僭称
せんしょう	先勝
せんしょくたい	染色体
せんしん	泉心
せんじょ	蟾蜍
せんじょう	煽情
せんすい	仙水
せんすいしん	潜水身
せんせい	先生
せんせんざん	千千斬
せんせんだんざん	扇扇断斬
せんぜい	占筮
せんぞく	千僧供
せんたく	選択
せんたくさいけん	選択債権
せんだい	仙大
せんだいがわ	千代川
せんだんくどくぶつ	旃檀功徳仏
せんちゃく	選択
せんちんじょう	仙鎮城
せんと	聖
せんと	遷都
せんとうきょしん	戦闘巨神
せんとごっどくろすふぁいたー	聖神竜合士
せんとどらごんちぇんじゃー	聖竜機化神
せんとほーりー	聖聖
せんとめたるちぇんじゃー	聖機竜化士
せんどう	煽動
せんにん	仙人
せんにんじゅう	扇忍獣
せんねつ	潜熱
せんねんざくら	千年桜
せんのたにこくえんこうざん	千野谷黒鉛鉱山
せんのまもりて	千の護手
せんばちゅうおう	船場中央
せんばやし	千林
せんぱつぐれごりおれき	先発グレゴリオ暦
せんひだん	扇披弾
せんひめ	千姫
せんぶ	先負
せんぶ	舛部
せんぶしゅう	贍部洲
せんぷういっせん	旋風一閃
せんぷうきのじゅつ	扇風機の術
せんぷうじん	旋風神
せんぷしん	潜布身
せんぼうのいずみ	閃望の泉
せんまいおろし	千枚おろし
せんめつ	殲滅
せんめつがいそう	殲滅外装
せんめつてんし	殲滅天使
せんゆう	専有
せんりゃう	仙蓼
せんりゅう	翦劉
せんりょうけん	遷陵県
せんる	遷流
せんれい	洗礼
せんれつのぎんろう	閃烈の銀狼
せんゐ	繊維
ぜいきん	税金
ぜいじゃく	脆弱
ぜいせい	税制
ぜいはぶせんちょう	ゼイハブ船長
ぜいびきごえいぎょうりえき	税引き後営業利益
ぜいむ	税務
ぜすとまーぐ	救世機
ぜず	銭司
ぜぜうら	膳所裏
ぜっかりょうらん	舌禍繚乱
ぜっくうほうよく	絶空鳳翼
ぜっしん	絶心
ぜつえいきしぞろ	絶影騎士ゾロ
ぜつぶ	舌部
ぜつむ	絶無
ぜに	銭
ぜむりあ	世界
ぜろ	零
ぜろくどう	零駆動
ぜろしき	零式
ぜん	全
ぜんきょひじんたい	前距腓靱帯
ぜんぐうすう	全偶数
ぜんこう	前項
ぜんこくみん	全国民
ぜんこんしゅうけつ	全魂集結
ぜんごそくいんがのごびゅう	前後即因果の誤謬
ぜんさむらいがったいでぃすく	全侍合体ディスク
ぜんしゃ	前車
ぜんしん	善真
ぜんしんねりまくり	全身練馬繰
ぜんじょう	禅城
ぜんせんけい	漸先形
ぜんそうよう	禅僧様
ぜんたい	全体
ぜんちしょうにん	善智上人
ぜんちゆう	全晝
ぜんとくじのかいめい	善徳寺の会盟
ぜんどううんどう	蠕動運動
ぜんぶ	全部
ぜんまい	薇
ぜんりんでんじゅ	全臨伝授
そいであめりか	南亜墨利加
そいのほうり	副祝
そいふぉん	砕蜂
そう	惣
そう	艘
そうい	創痍
そういえん	爪囲炎
そううん	宗吽
そうえもん	惣右衛門
そうえん	蒼鉛
そうか	痩果
そうかうにふだう	背高入道
そうかん	操艦
そうきゅう	蒼穹
そうきょ	漕渠
そうきょく	箏曲
そうぎょう	創業
そうぎょく	曹嶷
そうぎょく	蒼玉
そうぎんじょう	蒼銀杖
そうけんか	双懸果
そうけんがっしん	双剣合身
そうけんじょ	燥繭所
そうげん	草原
そうげんすいりぶんこ	創元推理文庫
そうごうふくしがくぶ	総合福祉学部
そうごく	葬獄
そうさ	捜査
そうさく	捜索
そうし	繰糸
そうしげもと	宗成職
そうしさんりえきりつ	総資産利益率
そうしゅうせいりゅうれんめいかい	相州聖龍連盟會
そうしょくがさ	装飾笠
そうじだいじんきれいずきー	掃治大臣キレイズキー
そうじゅ	奏授
そうじゅう	操縦
そうじゅうとう	操獣刀
そうじょうじゅ	鬆縄呪
そうせい	叢生
そうせいしん	創世神
そうせき	漱石
そうせん	操船
そうせんすいはちれんざん	掃扇捶八連斬
そうせんぷ	双戦斧
そうぜつとっしん	槍舌突針
そうそう	匆々
そうそう	草創
そうぞう	想像
そうぞうしゅ	創造主
そうぞうしん	創造神
そうぞうのしとみけら	創造の使徒ミケラ
そうたいせいりろん	相対性理論
そうたいてき	相対的
そうたつほうし	双竜法師
そうたん	草炭
そうだししぇりんだ	操舵士シェリンダ
そうついぶし	惣追捕使
そうてい	漕艇
そうてん	装填
そうてんきしざんこ	蒼天騎士斬虎
そうでぃすく	双ディスク
そうとう	争闘
そうとういんがかんけいせつ	相当因果関係説
そうねんぶ	壮年部
そうはつあたま	総髪頭
そうびしゃちょうせき	曹微斜長石
そうぶ	総武
そうぶ	艸部
そうぶ	走部
そうへい	爽平
そうほう	双方
そうほうこうてきすと	双方向テキスト
そうほんだな	総本店
そうま	相馬
そうみょう	草名
そうめい	滄溟
そうめいえいち	聡明叡智
そうもう	叢毛
そうもく	相撲
そうもんか	相聞歌
そうやく	装薬
そうやしんこう	宗谷侵攻
そうやじへん	宗谷事変
そうら	候
そうらん	総攬
そうりだいじんよごしまくりたいん	総裏大臣ヨゴシマクリタイン
そうりゅうがろ	蒼竜牙狼
そうりゅうけん	双竜剣
そうりゅうばし	双龍橋
そうりん	叢林
そうるこうつうこうしゃ	ソウル交通公社
そうれつゆうしんがろ	双烈融身ガロ
そうろ	候
そえうらこうさつ	添浦高札
そかい	泝洄
そがべ	曽我部
そくかきこ	即書呼
そくすい	涑水
そくせき	即席
そくそう	束装
そくたん	続旦
そくどく	速読
そくどろんてきどういたいこうか	速度論的同位体効果
そくばくへんすう	束縛変数
そくぶ	足部
そこ	底
そこくかいほう	祖国解放
そこな	傷
そこばく	若干
そこほん	底本
そごう	十合
そし	毀
そし	謗
そしか	粗視化
そしき	組織
そぜい	租税
そそ	雪
そそぎ	灌
そぞうか	塑像化
そたいほらー	素体火羅
そだい	粗大
そだいし	粗大視
そちょんじゅせん	西清州線
そっせんすいはん	率先垂範
そつじゅ	卆寿
そで	袖
そとうば	蘇東坡
そとがわ	外側
そとだやすすけ	外田保丞
そとなさかうら	外浪逆浦
そな	具
そなー	夢捜歌
そなー	歌
そね	猜
その	其
そのあした	其朝
そのじつ	其実
そのた	其他
そのだまさき	園田将生
そのゆえ	其故
そのらまぶんこ	ソノラマ文庫
そはんのう	素反応
そばかり	曾婆可理
そび	聳
そびそう	鼠尾草
そぶ	鼠部
そま	杣
そまたにがわ	杣谷川
そむ	叛
そむ	畔
そむ	背
そめがみ	染紙
そめや	染谷
そもそも	抑
そら	夜空
そら	天空
そら	宇宙
そら	宙
そらい	徂徠
そらがけ	空駆け
そらさきし	空崎市
そりゅうし	素粒子
それ	其
それ	爾
そろばん	算盤
そろもん	王統
そんぎょうじゃ	孫行者
そんごくう	孫悟空
そんざい	存在
そんし	尊士
そんせつ	撙節
そーさらー	妖術師
ぞうおだん	憎悪弾
ぞうか	造化
ぞうか	雑歌
ぞうかのかみ	造化の神
ぞうきんしぼり	雑巾しぼり
ぞうしょ	蔵書
ぞうぜい	増税
ぞうは	造波
ぞうぶつしゅ	造物主
ぞうへいきょく	造幣局
ぞく	俗
ぞく	屬
ぞくかん	俗間
ぞくへいやーとっと	賊兵ヤートット
ぞくべっとう	俗別当
ぞっこく	属国
ぞるーくとうじょう	ゾルーク東条
ぞろめ	ゾロ目
ぞーりま	ゾーリ魔
たい	対
たいあたり	體當り
たいいくよういん	体育要員
たいいつ	太一
たいかい	大海
たいがい	大概
たいがしら	鯛頭
たいがーあいず	猛虎の目
たいがーぞうきんがけ	タイガー雑巾がけ
たいがーどら	虎的盾鑼
たいきけん	大気圏
たいきばんせい	大木晩成
たいぎめいぶん	大義名分
たいぎゃくしんもん	大逆神門
たいげ	退下
たいこうてんのう	大行天皇
たいこもち	太鼓持ち
たいさいぼう	体細胞
たいざ	胎座
たいざ	間人
たいしげんすい	太子元帥
たいしゃく	大赤
たいしや	太子爺
たいしょう	大正
たいしょうじだい	大正時代
たいじ	対峙
たいじょうけい	大常卿
たいじょうじ	大常寺
たいじょうはく	大常伯
たいじょうろうくん	太上老君
たいすう	大数
たいせい	大政
たいせつ	大切
たいそう	大葬
たいそうはく	大宗伯
たいぞうえき	退蔵益
たいちゃん	大ちゃん
たいちょうへびづか	隊長蛇塚
たいていへいか	大帝陛下
たいはく	太白
たいはくどおり	大博通り
たいはくまち	大博町
たいびょう	大病
たいぶ	隶部
たいへいき	太平記
たいへいづか	大瓶束
たいへいふどき	太平風土記
たいへいよう	太平洋
たいほう	大宝
たいほう	大鵬
たいぼくれい	大卜令
たいまじょう	当麻城
たいまつ	松明
たいむす	時間
たいむりみっと	限界時間
たいも	大喪
たいやう	太陽
たいゆぁん	太原
たいようえねるぎー	太陽エネルギー
たいようのかみ	太陽神
たいようのつるぎ	太陽の剣
たいらい	泰東
たいらく	頽落
たいらじま	平島
たいりく	大陸
たうじ	當時
たうぶん	當分
たえ	妙
たえ	絶
たお	仆
たお	斃
たか	多珂
たか	高
たかあなほのみや	高穴穂宮
たかあまの	高天
たかあまのはら	多訶阿麻能播羅
たかいどふしなりきゅうり	高井戸節成胡瓜
たかいひと	堯人
たかいわさん	高岩さん
たかえ	高枝
たかお	高尾
たかおてつどう	高雄鉄道
たかおのおおかみ	高龗大神
たかぎ	高木
たかくすうていり	多角数定理
たかくら	高倉
たかさご	高砂
たかし	兀
たかし	隆
たかじょう	鷹匠
たかすずやま	高清水山
たかだ	高田
たかだま	高擶
たかちほ	高千穂
たかつかさじんじゃ	高司神社
たかつね	高雅
たかなし	小鳥遊
たかなみ	高波
たかね	高値
たかの	多珂
たかの	高
たかはし	高橋
たかはら	高原
たかはるちょう	高原町
たかば	鷹場
たかひろ	崇広
たかほこ	鷹架
たかまがはら	高天ヶ原
たかまがはら	高天原
たかまつえき	高松驛
たかまつし	高松市
たかみ	高見
たかみえみりー	高見エミリー
たかみざわ	高見沢
たかみみじんじゃ	高耳神社
たかみむすび	高御産巣日神
たかみや	高宮
たかみや	鷹宮
たかむら	鷹群
たかもりのかみ	高杜神
たかやまきょうじゅ	高山教授
たかやまごぼう	高山牛蒡
たかやままな	高山真菜
たから	資産
たかわし	高鸇
たが	多賀
たが	愆
たがい	互
たがや	耕
たがわ	它川
たがわ	田川
たき	瀧
たきもの	薫物
たぎしみみのみこと	当芸志美美命
たく	拓
たくとうりてんのう	托塔李天王
たくぬの	栲布
たくはいびん	宅配便
たくはつがさ	托鉢笠
たくみまち	工町
たくら	企
たぐち	田口
たぐちおとは	田口音羽
たけ	岳
たけ	猛
たけいえ	武家
たけおひろくにおしたてのみこと	建小広国押楯命
たけおみ	武臣
たけがさ	竹笠
たけこ	竹子
たけし	武士
たけし	猛士
たけした	竹下
たけじょう	竹生
たけだ	武田
たけだ	竹田
たけちのくろひと	高市黒人
たけなか	竹中
たけのかんのん	丘の観音
たけはにやすのみこ	建波邇安王
たけみかづちのかみ	建御雷神
たけみつ	竹光
たけみなかたのかみ	建御名方神
たけみや	健軍
たけみや	竹宮
たけもと	武本
たける	梟帥
たけわかまち	竹若町
たこうかん	多幸感
たこつぼ	蛸壺
たこむら	手腓
たしか	慥
たしなみ	嗜
たしま	田島
たしょう	多少
たしろ	田代
たしろたい	田代平
たしろやま	田代山
たじひ	多治比
たじま	田島
たじん	他人
たすう	多数
たすく	助
たすく	棐
たすく	翼
たず	尋
たずぬ	尋
たずね	尋
たせう	多少
たそがれ	黄昏
たぞの	田園
たた	叩
たた	敲
たた	畳
たたか	戦
たたかい	試合
たたかいだましい	闘魂
たたき	三和土
たたなみ	多他那美
たたみがみ	畳紙
たたみげさ	畳袈裟
たたら	多々良
たたら	多田羅
たたら	鞴
たたらがわ	多々良川
たたらしんかわ	多々良新川
ただ	但
ただ	只
ただ	唯
ただ	啻
ただ	糺
ただ	縄
ただかつ	忠功
ただち	直
ただち	直地
たち	質
たちかわ	立川
たちばな	橘
たちばな	立花
たちばなのとよひのみこ	橘豊日王
たちばなのとよひのみこと	橘豊日命
たちばなもん	橘紋
たちふじ	立藤
たちま	忽
たちやく	立役
たぢひべ	蝮部
たっきゅうびん	宅急便
たっきょ	謫居
たっぐ	相棒
たっこぶぬま	達古武沼
たつ	建
たつ	達
たつのやま	竜の山
たつまき	竜巻
たつまきにんれつざん	竜巻忍烈斬
たつみぼうさいけんきゅうじょ	巽防災研究所
たづ	鶴
たて	楯
たて	竪
たていと	経糸
たてえぼし	立烏帽子
たてがみ	鬣
たてしなのかみ	蓼科神
たてちょうすじ	竪町筋
たてでぃすく	盾ディスク
たてなおし	舘直志
たてなわて	田手畷
たてぬい	盾作
たてのおおまゆみ	舘の大マユミ
たてばぢゃや	立場茶屋
たてふじ	立藤
たてまつ	奉
たてまつ	貢奉
たてやま	館山
たと	仮令
たと	例
たと	假令
たとい	仮令
たとい	縦令
たとう	帖紙
たとうがみ	帖紙
たど	辿
たどうせいしょうがい	多動性障害
たどころ	田所
たどころはかせ	田所博士
たなか	田中
たなべはかせ	田辺博士
たに	谷
たにがき	谷垣
たにぐち	谷口
たにのきじゅう	谷の鬼十
たにやま	谷山
たにん	他人
たぬま	田沼
たね	実蓏
たね	種
たねがしまらいふる	種子島雷威銃
たねもみ	種籾
たねるい	種類
たの	恃
たの	負
たのし	娯
たのつ	多の津
たのもしき	頼母敷
たはむれ	戲
たばこ	煙草
たばこいれ	莨入
たび	旅
たびだち	出発
たふ	太布
たほうかい	多宝会
たま	多摩
たま	御
たま	玉
たま	魂
たまいりれいきゃくき	玉入り冷却器
たまくら	手枕
たまごはかせ	タマゴ博士
たましい	霊
たまちゅう	玉中
たまつくりくろもんしろうり	玉造黒門越瓜
たまで	玉手
たまのい	玉乃井
たまのい	玉井
たまはがね	珠鋼
たまほのみや	玉穂宮
たまみ	珠美
たまも	玉藻
たまもの	賜物
たまゆらひめ	玉響姫
たまよりひめのみこと	玉依姫命
たみ	人民
たみえ	たみ江
たむけやまはちまんぐう	手向山八幡宮
たむら	田村
ためいけ	溜池
たもと	袂
たものうら	玉藻浦
たや	田谷
たゆう	太夫
たゆうしゅう	太夫衆
たゆた	揺蕩
たら	誑
たらいくぼ	手洗窪
たらしなかつひこのすめらみこと	帯中日子天皇
たるがくしゃぶくらてす	樽学者ブクラテス
たれ	誰
たれすのていり	タレスの定理
たろう	太郎
たろうそうしろう	太朗想史郎
たろっとそーされす	魔符詠姫
たわんぞく	多腕族
たん	單
たんい	単位
たんうんぐん	唐恩郡
たんか	啖呵
たんかすいそ	炭化水素
たんぐうすう	単偶数
たんげ	丹下
たんご	端午
たんごきづ	丹後木津
たんしおしょう	蛋子和尚
たんしょくが	単色画
たんしん	丹心
たんじょうせき	誕生石
たんすいぎょ	淡水魚
たんそう	噉相
たんそかごうぶつ	炭素化合物
たんそんぐん	唐城郡
たんてい	端艇
たんでき	耽溺
たんどくほう	単独峰
たんばたかはら	丹波高原
たんぱたい	短波帯
たんぽ	湯婆
たんめん	湯麺
だい	大
だい	臺
だい	題
だいあろっく	氷壁
だいいちげんりけいろせきぶんぶんしどうりきがくほう	第一原理経路積分分子動力学法
だいういきょう	大茴香
だいうぼ	大禹謨
だいえ	大衣
だいえい	大永
だいえいかくだん	大鋭角断
だいえんかい	大猿回
だいえんきょうち	大円鏡智
だいおうけん	大王剣
だいかいしょう	大海嘯
だいかいてんししばくれつだん	大回転獅子爆裂弾
だいかいてんとどろきぎり	大回転轟斬り
だいかいほう	大魁咆
だいかんみんこくうぉん	大韓民国ウォン
だいかんみんこくぐんいあんふ	大韓民国軍慰安婦
だいかんみんこくのきょういく	大韓民国の教育
だいかんれき	大還暦
だいがさ	台笠
だいがんがんがん	大頑頑丸
だいがんがんきゃく	大頑頑脚
だいがんがんけん	大頑頑拳
だいがんがんざん	大頑頑斬
だいき	大喜
だいきょう	大饗
だいきょうだいきゃく	大兄弟脚
だいくうがったい	大空合体
だいくうまおう	大空魔王
だいくうまてい	大空魔艇
だいけんじんずばーん	大剣人ズバーン
だいこうけん	大甲剣
だいこうじんかぶてりおす	大甲神カブテリオス
だいこうみょうへんじょう	大光明遍照
だいこく	大黒
だいこくどおり	大黒通り
だいこくながれ	大黒流
だいごうごうじゅう	大合合獣
だいごうりゅう	大号竜
だいごやはたまる	第五八幡丸
だいごようじってうち	ダイゴヨウ十手打ち
だいさく	大作
だいさたん	大サタン
だいざぶろう	大三郎
だいし	第四
だいしきょう	大司教
だいしきょうかい	大師教会
だいしこう	大司寇
だいしゃ	台車
だいしゅりょう	大首領
だいしょうめつ	大消滅
だいしん	代神
だいしんきろう	大蜃気楼
だいしんけんさむらいぎり	ダイシンケン侍斬り
だいしんけんてんくうからたけわり	ダイシンケン天空唐竹割り
だいしんけんはおうぎり	ダイシンケン覇王斬り
だいじ	大切
だいじ	大治
だいじかん	大時間
だいじゅうじん	大獣神
だいじゅうどんか	大重鈍化
だいじゅうのう	台十能
だいじゅうりょく	大重力
だいじょうあびだつまきょう	大乗阿毘達磨経
だいじょうじまえまち	大乗寺前町
だいすうてききほんぐん	代数的基本群
だいずかす	大豆粕
だいせんだん	大旋断
だいせんぷう	大旋風
だいだいさいだいぎり	大大砕大斬り
だいだいまる	大橙丸
だいだんだん	大断断
だいち	代知
だいち	大地
だいちぎり	大地斬り
だいちこうたい	大地溝帯
だいちのかみ	大地神
だいてんくうじ	大天空寺
だいてんくうだいげきとつ	ダイテンクウ大激突
だいとも	大友
だいどう	大同
だいどうせん	大洞線
だいどうてんぐう	大鬧天宮
だいどがわ	大戸川
だいにじかいじゅうぶーむ	第二次怪獣ブーム
だいにほんせいとう	大日本製糖
だいひょうかいざん	大氷塊山
だいふうしゃぎり	大風車斬り
だいぶつ	大仏
だいぶつでん	大仏殿
だいぶんぶんきゃく	大分分脚
だいぶんぶんせん	大分分扇
だいほうでん	大放電
だいまおうぐれんごーすと	大魔王グレンゴースト
だいまじょぐらんでぃーぬ	大魔女グランディーヌ
だいみょう	大名
だいもつ	大物
だいもん	大門
だいやくん	代役ン
だいやつぶて	ダイヤ礫
だいり	内裏
だいり	大利
だいりはかせ	大利博士
だいりゅうかい	大龍海
だいりんけん	大輪剣
だいりんけんせんぷうぎり	大輪剣旋風斬り
だいれんおう	大連王
だいれんろっどくじゃくぎり	ダイレンロッド孔雀斬り
だいろうろうきゃく	大狼狼脚
だおしゃおびん	刀削氷
だくさつにそん	諾冊二尊
だくてん	濁點
だご	団子
だざいはかせ	太宰博士
だし	出汁
だし	山車
だしやぐら	ダシ矢倉
だじゃれ	駄洒落
だだだん	打打弾
だだーでぃーん	木曜日
だだーでいん	水曜日
だて	伊達
だば	駄馬
だひな	金曜日
だび	荼毘
だぶるいくす	機巧美神
だぶるせいばー	双刃剣
だむだむ	打無堕夢
だもると	火曜日
だらに	陀羅尼
だらにほん	陀羅尼品
だりん	舵輪
だるーあん	月曜日
だん	壇
だんくがえし	ダンク返し
だんしぶ	男子部
だんじ	弾次
だんた	壇田
だんだんがん	弾弾丸
だんだんはんまーくずし	弾弾ハンマー崩し
だーくどらごん	暗黒竜
ちあき	千秋
ちいみやえき	知井宮駅
ちぇいさー	追跡者
ちぇいん	縛鎖
ちぇうに	チェウニ
ちぇこきょうわこく	チェコ共和国
ちぇぼたれふのみつどていり	チェボタレフの密度定理
ちぇりこうきたくぶ	チェリ高帰宅部
ちえ	千恵
ちえ	智恵
ちえんきおくそうち	遅延記憶装置
ちおも	乳母
ちか	千果
ちか	近
ちかこ	俔子
ちかつあすかのみや	近飛鳥宮
ちかづ	近
ちかのり	近似
ちから	力
ちかんもじ	置換文字
ちきう	地球
ちきうじやう	地球上
ちきゅうかんそくえいせい	地球観測衛星
ちきゅうがいせいぶつ	地球外生物
ちきゅうがいせいめいたい	地球外生命体
ちきゅうたいきちゅうのにさんかたんそ	地球大気中の二酸化炭素
ちきゅうのたいき	地球の大気
ちきょうだい	乳兄弟
ちぎょう	恥行
ちくうじん	地空人
ちくごむびゅうせつ	逐語無謬説
ちくごやく	逐語訳
ちくし	遅来矢
ちくしぐちどおり	筑紫口通り
ちくしどおり	筑紫通り
ちくしょう	畜生
ちくそ	血屎
ちくばやま	筑波山
ちくぶ	竹部
ちくまがわ	千曲川
ちくわん	遲緩
ちぐるまとう	血狂魔党
ちぐるままじんさい	血車魔神斎
ちけい	智敬
ちけむりはくしゃくぶらっでぃ	血煙伯爵ブラッディ
ちこう	治功
ちご	稚
ちごづか	稚児塚
ちさつすう	地煞数
ちさつせい	地煞星
ちさつせいしちじゅうにせい	地煞星七十二星
ちさと	知里
ちしつ	知悉
ちしまれっとう	千島列島
ちしゃ	智者
ちしゅきふ	螭首亀趺
ちしょう	池沼
ちしょうかく	智正覚世間
ちすいじんじゃ	治水神社
ちせい	地勢
ちせん	薙染
ちたせい	智多星
ちだつ	褫奪
ちだぼくいっぽう	治打撲一方
ちちがしらくろみ	乳頭黒美
ちっきょ	蟄居
ちっこうほんまち	築港本町
ちつ	些
ちつ	小
ちつきよ	蟄居
ちていざめ	地底鮫
ちていじゅう	地帝獣
ちとく	智徳
ちなみ	因
ちぬおう	智努王
ちのりもこう	チノリモ綱
ちはや	千早
ちはる	千春
ちひつどう	遅筆堂
ちひろ	千翼
ちびのけのおとおさん	地尾野家のおとおさん
ちぶ	豸部
ちぶ	黹部
ちべつと	西藏
ちほうけいば	地方競馬
ちほうこうきょうだんたい	地方公共団体
ちほうじちたい	地方自治体
ちほうせいふ	地方政府
ちまつりどうこく	血祭ドウコク
ちまつりのぶれどらん	血祭のブレドラン
ちみつ	緻密
ちみつこつ	緻密骨
ちめい	地名
ちゃうぐん	チャウ群
ちゃくさい	嫡妻
ちゃくぶ	辵部
ちゃたておんな	茶立女
ちゃたろう	茶太郎
ちゃだ	チャダ
ちゃっか	着化
ちゃどう	茶道
ちゃみせ	茶店
ちゃやま	茶山
ちゃわんちゃうす	茶碗茶碓
ちゃん	喜屋武
ちゃんぷ	王
ちゃんぺいさん	長白山
ちやわんちやうす	茶碗茶臼
ちゅ	美
ちゅう	中
ちゅう	註
ちゅうおうちこうたい	中央地溝帯
ちゅうかんげんご	中間言語
ちゅうごくらおすてつどう	中国ラオス鉄道
ちゅうさつ	誅殺
ちゅうしょうきかい	抽象機械
ちゅうしん	中神
ちゅうじょ	駐鋤
ちゅうせいし	中性子
ちゅうせいしかじょうすう	中性子過剰数
ちゅうせいしばくだん	中性子爆弾
ちゅうぞうぎのうし	鋳造技能士
ちゅうたいき	駐退機
ちゅうだんげんすい	中壇元帥
ちゅうちゅうざん	宙宙斬
ちゅうちゅうしんし	虫中心市
ちゅうちょ	躊躇
ちゅうとうし	中闘士
ちゅうはたい	中波帯
ちゅうび	籌備
ちゅうぶてんりゅうえき	中部天竜駅
ちゅうぶほうげん	中部方言
ちゅうぼそけい	中細罫
ちゅうめいぶし	宙明節
ちゅうれん	駐輦
ちゅうれん	駐輿
ちゅしんとう	丶心道
ちゅそく	秋夕
ちゅぱかぶらのぶれどらん	チュパカブラの武レドラン
ちゅらばた	美ら旗
ちゅんあんいるぼ	中央日報
ちゅんちょんし	春川市
ちゅーにゃん	酒醸
ちゅーん	武装
ちゆうい	注意
ちゆうき	仲虺
ちょいちょい	超々
ちょう	蝶
ちょうあい	寵愛
ちょうあい	帳合
ちょうえいえいかげきざん	超鋭鋭過激気斬
ちょうえいとう	調栄湯
ちょうえきたろう	懲役太郎
ちょうおう	釣皇
ちょうおうくらぶ	釣皇倶楽部
ちょうがったいにんしゅりけん	超合体忍シュリケン
ちょうきゅう	長久
ちょうきゅうき	超吸気
ちょうきょう	調教
ちょうきょう	長享
ちょうぎん	朝銀
ちょうぎんがいけん	超銀鎧剣
ちょうぎんがおう	超銀河王
ちょうくちょくにゅう	長駆直入
ちょうけつしてんのう	釣傑四天王
ちょうげん	長元
ちょうげんしゅ	腸原種
ちょうこうしゅんがい	張郃儁乂
ちょうこく	肇国
ちょうこくじ	長谷寺
ちょうこたい	超個体
ちょうさむらいがったいでぃすく	超侍合体ディスク
ちょうし	銚子
ちょうしゃ	庁舎
ちょうしょ	牒書
ちょうしょう	長承
ちょうしょうじ	長松寺
ちょうしょく	朝食
ちょうしんかじゅう	超進化獣
ちょうしんせい	超新星
ちょうしんせいのぎょーてんおー	超新星のギョーテンオー
ちょうじ	長治
ちょうじゅうしん	超獣神
ちょうじゅうりゅうばくえん	超重龍爆炎
ちょうじょうげんしょう	超常現象
ちょうじょうてき	重畳的
ちょうせい	朝誠
ちょうせん	朝鮮
ちょうせんきぞく	朝鮮貴族
ちょうせんこうさい	朝鮮交際
ちょうせんご	朝鮮語
ちょうせんごぞく	朝鮮語族
ちょうせんごのぶんぽう	朝鮮語の文法
ちょうせんごのろーまじひょうきほう	朝鮮語のローマ字表記法
ちょうせんごばんうぃきぺでぃあ	朝鮮語版ウィキペディア
ちょうせんじん	朝鮮人
ちょうせんにっぽう	朝鮮日報
ちょうせんはんとう	朝鮮半島
ちょうせんほうそう	朝鮮放送
ちょうぜい	徴税
ちょうぜっしん	超絶心
ちょうぜったいやらねーだ	超ゼッタイヤラネーダ
ちょうぜつしゅりけんざん	超絶シュリケン斬
ちょうぜつしょうげきばくれつざん	超絶衝撃爆裂斬
ちょうぜつしょうぶちぇんじゃー	超絶勝負チェンジャー
ちょうそう	張璁
ちょうそうこうぎんがいおー	超装光ギンガイオー
ちょうちょう	漲長
ちょうちょうとっきゅうだいおー	超超トッキュウダイオー
ちょうでんじちょくげきほう	超電磁直撃砲
ちょうとく	長徳
ちょうとっきゅうおー	超トッキュウオー
ちょうどきゅうせんかん	超弩級戦艦
ちょうにち	朝日
ちょうにんぽうおおぶろしき	超忍法大風呂敷
ちょうにんれつざん	超忍烈斬
ちょうねんねんだん	超捻捻弾
ちょうばくれつりゅうじんづき	超爆裂龍神突き
ちょうばん	打板
ちょうばんばんちゅう	超蛮蛮肘
ちょうぶ	長部
ちょうぶ	鬯部
ちょうぶ	鳥部
ちょうほう	長保
ちょうむげんれっぱ	超無限烈破
ちょうりゃく	長暦
ちょうりゅうじん	超竜神
ちょうろく	長禄
ちょうわ	長和
ちょうをゆめむ	蝶を夢む
ちょえん	褚燕
ちょか	猪牙
ちょくし	直使
ちょくじゅ	勅授
ちょくそう	直繰
ちょくやく	直訳
ちょごうりょう	猪剛鬣
ちょごのう	猪悟能
ちょしゃ	著者
ちょしょ	著書
ちょじつ	著述
ちょっかく	直角
ちょっかくさんかくけい	直角三角形
ちょっけんしょうこくじ	勅建相国寺
ちょはっかい	猪八戒
ちょま	苧麻
ちょろきち	チョロ吉
ちょん	ゝ
ちょんじゅし	清州市
ちょんわで	青瓦台
ちよいちよい	一寸々々
ちようど	丁度
ちようふじん	地湧夫人
ちようもん	聴聞
ちよく	直
ちよしや	著者
ちよしよ	著書
ちよやく	著訳
ちらくいん	智楽院
ちり	地理
ちり	塵
ちりがく	地理学
ちりく	千栗
ちりひとは	塵芥一片
ちりふうぞく	地理風俗
ちりゆう	池鯉鮒
ちれいほう	地霊砲
ちろくじんじゃ	地禄神社
ちん	琴
ちんい	陳褘
ちんがく	陳蕚
ちんじゃ	螣蛇
ちんとう	椿東
ちんどんや	チンドン屋
ちんのくしゃみ	珍野苦沙弥
ちんぶ	鎮撫
ちんぷんかんぷん	陳奮翰奮
ちーと	神様
ちーとらいふ	勇者生活
ちーふー	芝罘
ぢいろ	地色
ぢか	直
ぢめん	地面
ぢゃんぼ	両棒
ぢろん	持論
つぁいてん	載湉
つい	就
つい	竟
つい	終
ついく	対句
ついたち	朔
ついたちいち	朔日市
ついで	序
ついや	費
ついんてーる	戦士
つう	通
つうしん	通信
つうしんえいせい	通信衛星
つうぞく	通俗
つうぞくきよういく	通俗教育
つうだつい	通達位
つうどく	通読
つうどく	通讀
つうのしょう	都宇荘
つうろ	通路
つか	事
つか	掴
つか	搤
つか	欛
つかいま	遣い魔
つかいまいんぷす	使い魔インプス
つかさ	司
つかさど	主
つかさほう	司法
つかもと	塚本
つかり	束荷
つかれ	衰弱
つがい	番
つき	月
つき	竭
つきあい	交際
つきうす	搗臼
つきさむ	月寒
つきだの	衝田
つきぬきそう	独用将軍
つきのかみ	月神
つきのまなこ	月の眼
つきのものこ	月野物子
つきのわ	月ノ輪
つきのわ	月之輪
つきもりちょう	月森町
つぎ	駅
つく	作
つく	創造
つく	捏
つく	盡
つく	造
つくも	九十九
つくもがみ	九十九髪
つくよね	舂米
つくよみのみこと	月読命
つくり	創造
つくり	旁
つぐのみや	繼宮
つけくは	附加
つけたり	付
つけたり	附
つしまおめがきょく	対馬オメガ局
つじいしゃ	辻医者
つじうらせんべい	辻占煎餅
つた	流
つたかずらきそのかけはし	蔦葛木曽桟
つたのは	蔦の葉
つだ	津田
つちくら	土倉
つちくらさわ	土倉沢
つちくれ	壌
つちけむりのまい	土煙りの舞い
つちのじぎり	土の字斬り
つちばくしん	土驀進
つっけんどん	突剣呑
つつ	豆酘
つつ	銃
つつぐら	高津座
つつし	謹
つつじだい	ツツジ台
つつもたせ	美人局
つづ	綴
つづみ	皷
つづらおがさ	葛小笠
つづらおざき	葛籠尾崎
つづらふじ	葛藤
つづらぼうし	葛帽子
つづれおり	綴織
つと	勉
つと	勤
つとむ	務
つとめ	盗め
つとめ	職掌
つど	集
つな	繋
つなきち	綱吉
つなてみち	綱手道
つなばまち	綱場町
つなよし	綱良
つね	常
つね	恆
つねこと	平言
つねのり	恒憲
つねもち	恒持
つの	発想
つの	角
つのぐひ	角杙神
つのだる	角樽
つのはず	角筈
つば	鍔
つばきたに	椿谷
つばくろ	燕子
つばくろのじんぺい	燕の甚平
つばさ	羽翼
つばさげんしゅ	翼原種
つばさびとがろ	翼人ガロ
つひ	終
つひや	費
つぶ	粒
つぶる	瞑る
つぼ	莟
つぼい	坪井
つぼがさ	壷笠
つぼねがさ	局笠
つぼみ	蕾
つぼみがさ	窄笠
つまおりがさ	褄折笠
つまさき	妻崎
つまざき	妻崎
つましなひめのみこと	妻科媛命
つましょうじ	対馬小路
つまびらか	詳
つまやみずひめのみこと	妻耶美豆媛命
つみ	罪
つみむくい	罪報
つむじ	旋風
つめげんしゅ	爪原種
つも	積
つゆお	露置
つよし	剛
つよし	剛史
つら	列
つらな	列
つりがき	釣書
つる	弦
つる	蔓
つるぎ	剣
つるぎ	聖剣
つるぎじま	剣島
つるぎじまん	剣自慢
つるぎたち	剣太刀
つるしがため	吊姿固
つるしゅりけん	鶴手裏剣
つるひめ	鶴姫
つるまくり	瓜蔓抄
つるや	鶴屋
つわもの	強者
つんどく	積ん読
つーあん	慈安
つーしー	慈禧
つーりすと	観光客
づあん	圖案
づうせばし	道瀬橋
てぃえんじん	天津
てぃえんらん	天藍
てぃらん	暴君
てい	底
てい	手入
てい	氐
ていえん	庭園
ていおうけんへるふぁんぐ	底皇剣ヘルファング
ていかう	抵抗
ていかんのま	帝鑑間
ていぎょく	丁玉
ていこうりつ	抵抗率
ていさい	体裁
ていしゃば	停車場
ていしゃふらん	蹄叉腐爛
ていじん	氐人
ていたんこうこう	帝丹高校
ていたんしょうがっこう	帝丹小学校
ていだん	梯団
ていだん	鼎談
ていちょう	啼鳥
ていていきゃく	蹄蹄脚
ていぶ	鼎部
ていへい	帝昺
ていほん	定本
ていぼく	低木
ていみ	丁未
ていむずがわ	堤向津川
ていむずがわ	堤無津川
ていりつ	鼎立
てうこく	肇國
てうし	調子
てえぶるくろーす	食卓布
てがさ	手傘
てき	剔
てき	敵
てき	滴
てきしゆう	敵讐
てきすいにゃんにゃん	滴水娘々
てきはつ	摘發
てきや	的屋
てぐるま	手車
てこき	手コキ
てごまる	手子生
てしまいえうら	豊島家浦
てしまからと	豊島唐櫃
てしまこう	豊島甲生
てしまゆういちろう	手島雄一郎
てすためんと	契約者
てすためんと	聖典
てすためんと	魔法契約
てっかば	鉄火場
てっこうへい	鉄鋼兵
てっさい	鉄砕
てっしゅうそうく	徹岫宗九
てっせん	鉄線
てっせんこうしゅ	鉄扇公主
てっちさん	鉄囲山
てっちせん	鉄囲山
てっぱつげんしゅ	鉄髪原種
てっぺん	天辺
てっぽうでんらい	鉄砲伝来
てつ	姪
てつ	耋
てつおうぎ	鉄扇
てつかぶと	鉄甲
てつぎゅう	鉄牛
てつさぶろう	銕三郎
てつじろう	銕次郎
てつじんせいせん	鉄神星戦
てつたぬき	鉄狸
てつどうふぁん	鉄道ファン
てつどうゆうびんきょく	鉄道郵便局
てつびん	鉄瓶
てならい	手習
てなれ	手馴
てのめ	手ノ目
てふ	蝶
てほん	手本
てみずしゃ	手水舎
てらこや	寺小屋
てらこやりゆう	寺小屋流
てらさわ	寺沢
てらづか	寺塚
てらやま	天良山
てらやま	寺山
てるくに	輝国
てるひひめ	輝日姫
てろりすと	恐怖政治家
てろる	恐怖
てん	天
てん	貂鼠
てんあん	天安
てんいねつ	転移熱
てんえい	天永
てんおう	天応
てんおん	唸音
てんかい	天蓋
てんかいざんさんきょうだい	天海山三兄弟
てんかこうせい	天下後世
てんかだいせんとそうこう	天下大闡都僧綱
てんかとういつぶそうにんじゃみせん	天下統一武奏ニンジャミセン
てんがい	天蓋
てんがじゅう	天鵞絨
てんきゅうきしがい	天弓騎士牙射
てんきょうき	転経器
てんきよほう	天気予報
てんぎ	天喜
てんぎょう	天慶
てんくうきでん	天空気殿
てんくうこうこう	天空高校
てんくうごうらいじん	天空轟雷神
てんくうごうらいせんぷうじん	天空轟雷旋風神
てんくうざん	天空斬
てんくうじん	天空神
てんくうせんぷうじん	天空旋風神
てんくうだいせいじゃまじえる	天空大聖者マジエル
てんくうだいふうしゃ	天空大風車
てんくうのまい	天空の舞い
てんくうまそうぎり	天空魔槍斬り
てんくうれっぱ	天空裂破
てんぐ	天愚
てんけんこうしんがろ	天剣煌身ガロ
てんげん	天元
てんげんじ	天幻寺
てんげんせいろっどあろー	天幻星ロッドアロー
てんこう	天皇
てんこうせい	天罡星
てんこうせいさんじゅうろくせい	天罡星三十六星
てんさい	甜菜
てんさん	天蚕
てんしぞく	天使族
てんしのいちらん	天使の一覧
てんしゃ	転写
てんしょう	天承
てんしょう	天象
てんしょうがろ	天翔牙狼
てんしょうらいげきほう	天翔雷撃砲
てんしょうらくど	天照楽土
てんしんはん	転身反
てんじ	天治
てんじきとくち	転識得智
てんじくてん	天軸転
てんじょう	天井
てんじん	天神
てんそう	纏創
てんそうじゅつ	天装術
てんそんこうりん	天孫降臨
てんたい	天体
てんだ	転舵
てんだいちぎ	天台智顗
てんだいほっけしゅう	天台法華宗
てんちてんべんだ	天地転変打
てんちばんぶつ	天地万物
てんちゅう	天幬
てんちょう	天長
てんちょー	店長
てんちらかしけんぽう	天地羅荷死憲法
てんてきかんがい	点滴灌漑
てんてんだん	転転弾
てんと	奠都
てんとく	天徳
てんどうぐみ	天童組
てんどばくとつ	天怒爆突
てんな	天和
てんにん	天仁
てんねん	天然
てんのう	天皇
てんのうじかぶら	天王寺蕪
てんのうへいか	天皇陛下
てんのかわ	天ノ川
てんのこえ	天の声
てんのとう	天の塔
てんびんぼう	天秤棒
てんぴょうかんぽう	天平感宝
てんぴょうしょうほう	天平勝宝
てんぴょうほうじ	天平宝字
てんぶん	天文
てんぷうらいげきは	天風雷撃波
てんぷく	顛覆
てんぷるそーど	法剣
てんぺすたす	魔天世界
てんぽう	天保
てんぽうげんすい	天蓬元帥
てんぽうらいらいのたま	天宝来来の玉
てんまかいてんげり	天馬回転蹴り
てんまこうそくかいてんげり	天馬高速回転蹴り
てんまこうふくのぎ	天魔降伏の儀
てんますーぱーかいてんげり	天馬スーパー回転蹴り
てんまぬんちゃく	天馬ヌンチャク
てんみょう	天明
てんめん	纒綿
てんもくどうしんぷろじぇくと	天目童心プロジェクト
てんもん	天文
てんもんげんしょう	天文現象
てんやまち	店屋町
てんらいせんぷうじん	天雷旋風神
てんりゃく	天暦
てんりんげんのう	転臨幻納
てんろく	天禄
てーぜ	命題
であいぢゃや	出会茶屋
でぃすとぴあ	反理想社会
でぃすびるしゃな	神滅者
でぃーぷないとう	ディープ内藤
でぃーる	契約成立
でぃーゔぁ	歌姫
でいさんかい	泥参会
でいさんかい	泥惨会
でいどりーむ	白昼夢
でか	出来
でか	刑事
でげねりあか	デゲネリア科
でざしん	デザ神
でし	弟子
でじたるちょさくけんかんり	デジタル著作権管理
でじま	出島
ですげーむ	死試合
ですとろいや	破恢者
ですばとる	死闘
でたらめ	出鱈目
でっかでかとうま	でっかでか東馬
でっくあーるゔ	闇のエルフ
でっくあーるゔ	闇の妖精
でっくあーるゔ	黒エルフ
でば	出庭
でみ	亜人
でみうるごす	虚ろなる神
でみうるごす	虚神
でもないず	魔人化
でもんあっくす	魔人斧
でゅありずむ	魔工契約
でゅえっと	二声楽
でゅなみすと	適能者
でゅわーれいきゃくき	デュワー冷却器
でゅーく	砂爵
でるたかんすう	デルタ関数
でんいん	田禋
でんえいばこ	電影箱
でんえん	田園
でんきこうじし	電気工事士
でんきていこうりつ	電気抵抗率
でんきでんどうりつ	電気伝導率
でんきぶんかい	電気分解
でんげきしょうせつたいしょう	電撃小説大賞
でんこうかいてんぎり	電光回転切り
でんこうらいごう	電光雷轟
でんこうらいだーきっく	電光ライダーキック
でんさんき	電算機
でんしかく	電子殻
でんしけいさんき	電子計算機
でんししゅっぱん	電子出版
でんしせいふ	電子政府
でんしゃとっしん	電車突進
でんじきがく	電磁気学
でんじきりょく	電磁気力
でんじそうごさよう	電磁相互作用
でんじゃんほー	電磁荷台
でんせいかん	伝声管
でんせつがっしん	伝説合神
でんそくでんりゅう	電束電流
でんち	田地
でんちゅう	殿中
でんでんせい	電電星
でんどうし	伝道師
でんのうぷらんと	電脳植物
でんぱ	電波
でんぶ	臀部
でんまーくまる	丁抹丸
でんらん	電纜
でんりょくこうがく	電力工学
でんわ	電話
でんわせんせい	電話先生
でーたさいえんすがくぶ	データサイエンス学部
でーたのかんぜんしょうきょ	データの完全消去
でーもんどらごん	魔黒竜
でーんじん	デーン人
といしぐるま	砥石車
といばらい	刀伊祓
とぅれっとしょうがい	トゥレット障害
とぅんちゅんせん	東涌線
とう	投
とう	筒
とうあこくないこうくう	東亜国内航空
とうあにっぽう	東亜日報
とういつしょうじほうてん	統一商事法典
とうえい	東瀛
とうか	豆果
とうかいどうごじゅうさんつぎ	東海道五十三次
とうかん	投函
とうが	鵃鵝
とうがゆ	淘鵝油
とうきょうけん	東京圏
とうきょうこころおぼえ	東京心覚
とうきょうごりん	東京五輪
とうきょうふつがっこう	東京仏学校
とうきょうべん	東京弁
とうきょうほうがくしゃ	東京法学社
とうきょうほうがっこう	東京法学校
とうきょくけつごう	等極結合
とうぎん	当今
とうぎんのみかど	当今の帝
とうけいりきがく	統計力学
とうこう	東光
とうこう	陶工
とうこうじけんずかこふん	東光寺剣塚古墳
とうこうじまち	東光寺町
とうことく	唐古特
とうごう	東郷
とうごうかいはつかんきょう	統合開発環境
とうごつ	檮杌
とうさすうれつ	等差数列
とうざいここん	東西古今
とうざいや	東西屋
とうし	藤氏
とうしきぶ	藤式部
とうしぎんこう	投資銀行
とうしょうかぶかしすう	東証株価指数
とうしょうしんしゅう	東勝神州
とうしょうしんしゅう	東勝身洲
とうしょぶ	島嶼部
とうじ	当時
とうじしゃ	当事者
とうじゃ	螣蛇
とうじょう	東上
とうじんがさ	唐人笠
とうじんせつわい	唐人説薈
とうじんちゅうがっこう	福岡市立当仁中学校
とうじんまちにし	唐人町西
とうせい	搗精
とうせんきょうきょうでんゆうすい	唐船峡京田湧水
とうせんしょうぶつ	闘戦勝仏
とうぜん	當然
とうそうぎ	陶宗儀
とうそく	橈側
とうた	淘汰
とうだがわ	藤田川
とうちきこう	統治機構
とうちこういろん	統治行為論
とうちゅう	東中
とうちゅう	灯中
とうてき	投擲
とうてつもん	饕餮文
とうと	東都
とうと	貴
とうとう	滔滔
とうとかんじょうせん	東都環状線
とうとすたじあむ	東都スタジアム
とうとたわー	東都タワー
とうとべるつりーたわー	東都ベルツリータワー
とうどう	東道
とうにん	当仁
とうにんしょうがっこう	福岡市立当仁小学校
とうの	当尾
とうはつ	膅発
とうはん	登攀
とうびょうち	投錨地
とうふくじ	東福寺
とうぶ	豆部
とうぶ	鬥部
とうほう	東部
とうほうきょうかい	東方教会
とうほうてん	東方天
とうほうりっこく	東方六国
とうみ	唐箕
とうみ	東海
とうめい	透明
とうようだい	桐陽台
とうよこ	東横
とうらい	到来
とうり	撐犁
とうり	東離
とうり	桐李
とうりょう	桃陵
とうりょうえいよ	東陵永璵
とうれい	桃麗
とうろう	蟷螂
とお	遠
とおしや	通屋
とおめがね	遠眼鏡
とおやま	遠山
とおりじ	通字
とおる	透
とかく	兎角
とかち	十勝
とかま	外鎌
とかられっとう	吐噶喇列島
とが	咎
とががわ	利賀川
とがくしさんけんこうじるきならびにじょ	戸隠山顕光寺流記
とがくしさんけんこうじるきならびにじょ	戸隠山顕光寺流記并序
とがし	富樫
とがり	鳥狩
とがりがさ	尖笠
とがりょう	科料
とき	刻
とき	斎
とき	時
とき	時節
とき	時間
とき	瞬間
とき	節
とき	釋
ときいろ	鴇色
ときたくん	時田くん
ときまる	時丸
ときむらはかせ	時村博士
ときよ	時代
ときわか	常若
ときわがくえん	常磐学園
ときわそう	トキワ荘
ときをり	時折
とぎれ	戸切
とく	特
とく	犢
とく	解
とくい	得意
とくいてんかいしょう	特異点解消
とくがわみち	徳川道
とくきょう	特矯
とくぎ	徳誼
とくさか	徳叉迦
とくさつえいが	特撮映画
とくしか	篤志家
とくしげうばらたいこおどり	徳重大バラ太鼓踊り
とくじ	徳治
とくそうたい	特捜隊
とくていぶつさいけん	特定物債権
とくとうせき	山下
とくぼう	特防
とけい	時計
とげ	棘
とげ	遂
とこ	床
とこうしゃいちとくていふぉーむ	渡航者位置特定フォーム
とこなべじょう	常滑城
とこやすみね	常安峰
ところ	処
ところ	所
ところあらわし	露顕
ところしめ	処湿
とこをとめ	常少女
とさ	登佐
とさか	鶏冠
とさこうこうさっかーらくらいじこ	土佐高校サッカー落雷事故
としお	壽雄
としろう	敏郎
とじ	刀自
とじきみ	軾
とそ	唐湊
とそつてん	兜率天
とたに	戸谷
とち	土地
とちおとめ	栃乙女
とっかてん	特火点
とっかんきょうしゃづき	突貫香車突き
とっけいてちょう	特警手帳
とったべつがわ	戸蔦別川
とっぷうじごく	突風地獄
とっぷがわ	徳富川
とつ	嫁
とつかんすう	凸関数
とて	迚
ととやみち	魚屋道
とど	海馬
とどま	止
とどま	留
とどり	闘鶏
とどろ	轟
とどろきまる	轟丸
となえ	名称
とにと	雷
とぬし	戸主
とね	刀禰
とねり	舎人
とのい	宿直
とばく	賭博
とばつびしゃもんてん	兜跋毘沙門天
とばどの	鳥羽殿
とばり	夜帷
とばり	帳
とびいづな	飛飯綱
とびた	飛田
とびのお	鴟尾
とぶひ	烽火
とべら	戸牧
とほ	透
とほ	遠
とほつあすかのみや	遠飛鳥宮
とまこまい	苫小牧
とまり	泊
とみお	寶受郎
とみおか	富岡
とみおがわ	富雄川
とみためそっど	冨田研究室
とめ	留
とめじるしょうちゅう	留汁焼酎
とも	共
とも	点
ともこ	智子
ともしび	灯
ともな	伴
ともにみんしゅとう	共に民主党
ともびき	友曳
ともまるさい	供丸斎
ともまるさいのみこと	供丸斎命
ともまるひめ	供丸姫
とや	戸矢
とやましりつとしょかん	富山市立図書館
とよ	登与
とよ	響
とようら	豊浦
とよくに	豊国
とよくにまる	豊国丸
とよくもの	豐雲野神
とよじ	登代路
とよながあこうま	豊永赤馬
とよはま	豊浜
とよひら	豊平
とよみけかしきやひめのみこと	豊御食炊屋比売命
とよもと	豊職
とら	制さ
とらいはっかい	土雷八骸
とらお	トラ男
とらおりがみ	虎折神
とらごりんだん	虎五輪弾
とらっぷますたー	罠使い
とらつき	虎衝
とらでぃすく	虎ディスク
とらどりるとつげき	虎ドリル突撃
とらべる	旅行社
とらめ	刀良女
とらんざくしょんしょり	トランザクション処理
とり	取
とり	雞
とりあ	取合
とりあつ	取集
とりあつか	取扱
とりい	鳥居
とりおいがさ	鳥追笠
とりおとこ	鳥男
とりかい	鳥飼
とりかいおおはし	鳥飼大橋
とりかいなす	鳥飼茄子
とりこ	虜
とりさば	取捌
とりしま	鳥島
とりすあぎおん	覇者の三剣
とりずなー	反逆者
とりちうむ	三重水素
とりばな	鳥花
とるねーどばばあ	トルネード婆々
とるばどぅーる	創作家
とろいちだんてつ	都盧一團鐵
とわ	永遠
とわだじゅうり	十和田充莉
とをまりよとせ	十四歳
とんがりがさ	とんがり笠
とんこう	敦高
とんざ	頓挫
とんそう	遁走
とんだはかせ	屯田博士
とんち	頓智
とんちき	頓痴気
とんとん	豚々
とんとんてい	豚々亭
とんびかん	豚尾漢
とんや	問屋
とんやんぴん	東洋兵
とーなー	唐名
どいどおり	土居通り
どいながれ	土居流
どいや	問屋
どぅーちぇ	統帥
どういろ	銅色
どうえん	導円
どうかつ	恫喝
どうかんぐら	道灌蔵
どうかんすう	導関数
どうきどろっぷ	童鬼ドロップ
どうきょう	銅鏡
どうぎょうににん	同行二人
どうけいしゃぞう	同型写像
どうこく	慟哭
どうこくがん	慟哭丸
どうしゅう	銅銹
どうしゅうせい	道州制
どうしょく	同色
どうしよくぶつ	動植物
どうじ	同時
どうじ	道寺
どうじきょくがく	童子曲学
どうせい	銅青
どうたく	銅鐸
どうでんりつ	導電率
どうどう	豆豆
どうどうむら	百々村
どうぶつへんげのじゅつ	動物変化の術
どうみゃく	動脈
どうもう	獰猛
どうやう	同樣
どうよう	同様
どうらくざんまい	道楽三昧
どうるゐ	同類
どがい	度外
どき	怒鬼
どくしほう	毒刺砲
どくしや	読者
どくしや	讀者
どくしゅ	読手
どくたー	博士
どくたーこうが	ドクター甲賀
どくたーしいな	ドクター椎名
どくたーひろせ	ドクター広瀬
どくたーみやま	ドクター三山
どくぶつおよびげきぶつとりしまりほう	毒物及び劇物取締法
どくりつ	独立
どくりつ	獨立
どくりつへんすう	独立変数
どくわう	独王
どぐら	怒蜘羅
どごうけんげきど	土豪剣激土
どしょうまち	道修町
どっかくじだいおう	独角兕大王
どっかくじだいおう	獨角兕大王
どっきょし	独居死
どっぽう	独峰
どとうのさめ	怒濤の鮫
どなうきゅう	ドナウ級
どばし	土橋
どぶ	溝
どぶいけすじ	丼池筋
どまめだいだんだん	土豆大断断
どみにおん	守護騎士
どらき	怒羅鬼
どらぐなー	竜騎士
どらごん	龍
どらごんちぇんじゃー	竜機化神
どらごんふゅーじょん	龍合身
どりす	朵莉丝
どりんき	怒臨気
どりんきおほうつく	怒臨気雄峰突
どりんきほんりゅうごうてんへん	怒臨気奔流豪天変
どるいど	森呪遣い
どれつばくせんほう	怒裂爆閃砲
どろ	泥
どろかわ	洞川
どわーふ	侏儒
どん	呑
どん	首領
どんぐりじょうか	どんぐり状果
どんさい	鈍才
どんす	緞子
どんだけい	鈍打刑
どんちょう	緞帳
どーる	黄金
どーるぶれいぶ	人形剣士
なあ	名有
ない	川
ないかくそうりだいじんふじん	内閣総理大臣夫人
ないがい	内会
ないし	乃至
ないしよ	内密
ないしん	内心
ないしんのう	内親王
ないせい	内省
ないそく	内側
ないちんげーるらぶそんぐ	小夜啼鳥恋詩
ないていこうぞく	内廷皇族
ないと	騎士
ないとがんだむらんさー	騎士ガンダムランサー
ないとふぉーる	黄昏時
ないどう	内藤
ないむしょうえーじぇんとぷろぐらむささき	内務省エージェントプログラム佐々木
なうそ	曩祖
なえ	苗稼
なお	直
なおいのうじ	名負氏
なおかつ	尚且
なおや	名祖
なか	中
なか	勿
なか	那珂
なかおはかせ	中尾博士
なかがつおとりしま	中鰹鳥島
なかがみがんさい	中神怡顔斎
なかがわ	中川
なかきゅうしゅう	中九州
なかご	中子
なかごえ	中越
なかござみこし	中御座神輿
なかごふくまち	中呉服町
なかじ	中路
なかじまうおと	中嶋魚豊
なかぞなえ	中備
なかぞね	中埣
なかっぺてんりゅうえき	中部天竜駅
なかつくに	中つ国
なかつみち	中津道
なかつる	中津留
なかとみのいかつおみ	中臣烏賊津
なかどいまち	中土居町
なかどん	楼丁
なかなか	中々
なかば	半
なかばる	仲原
なかひえこうえんどおり	中比恵公園通り
なかむら	中村
なかむらまち	中村町
なかもず	中百舌鳥
なかやしき	中邸
なかやま	中山
なかんずく	就中
なが	永遠
なが	眺
ながあき	長明
ながあきら	長暠
ながえ	轅
ながえ	長枝
ながえ	長江
ながお	長尾
ながおか	長丘
ながこ	良子
ながさき	長崎
ながし	長
ながす	長洲
ながた	長田
ながな	長名
ながなのせがれ	長名の伜
ながぬま	長沼
ながのおきまろ	長意貴麻呂
ながのけんちゅうぶじしん	長野県中部地震
ながみや	良宮
ながもの	長物
ながれかんじょうどおり	流灌頂通り
ながれなぎ	流凪
なき	亡
なぎ	凪
なぎがま	薙鎌
なぎのぶたい	凪の部隊
なぐさ	慰
なぐぬみじぐゎー	名護ぬ水小
なげう	抛
なこうじ	若王寺
なこおがー	名古川
なこく	奴国
なごのうら	長太ノ浦
なごやさげんた	名越左源太
なごやたな	名古屋店
なごり	名残
なじ	馴染
なじま	名島
なじみ	馴染
なす	為
なすぐじ	夏直路
なすのよ	那須与
なすみ	那須美
なぞのせいねん	謎の青年
なたさんたいし	哪吒三太子
なたししょ	奈多支所
なたたいし	哪吒太子
なだれ	山崩
なっしょ	納所
なつ	夏
なつ	菜摘
なつき	那月
なつごおり	夏氷
なつまつり	夏祭り
なつめだ	棗田
なつめやしき	夏目屋敷
なづ	名
なでしこ	撫子
なとりひろむ	名取宏
など	抔
など	等
ななか	七夏
ななくさ	七種
ななこ	七虹
ななこ	菜々子
ななしれんぢゅう	ナナシ連中
ななそぢまりやとせ	七十八歳
ななとき	七時
ななみ	七海
なに	何
なにごと	何事
なにもの	何物
なにわ	魚庭
なにわけり	浪花蹴り
なにわすじ	なにわ筋
なのかわ	那の川
なのり	名乗
なはおおつなひきまつり	那覇大綱挽まつり
なはまつり	那覇祭り
なばら	南原
なばりのたつまき	名張のタツマキ
なべまつ	双松
なべわりやま	鍋割山
なほちょう	奈保町
なま	生
なまえ	名前
なまき	生木
なまぐさ	葷
なまぐさ	風腥
なまにく	生肉
なみ	波
なみ	波濤
なみかわ	波川
なみがしら	波頭
なみき	並木
なみきのみや	列木宮
なみしづか	波陬
なみだ	涙
なみだがわ	泪川
なみだなが	涙流
なみなみざん	波波斬
なみゃんぐん	南陽郡
なめちょう	嘗帳
なめやく	嘗役
なめらか	滑
なや	悩
なら	並
なら	倣
なら	傚
なら	均
ならくのもり	奈落の森
ならはら	奈良原
ならびどう	双堂
ならやまち	奈良屋町
なり	形
なりたとうそう	成田闘争
なりとう	斉広
なりひろ	業広
なりわい	生業
なるせ	南流勢
なるたき	鳴滝
なるで	成出
なるひと	徳仁
なわしろ	苗代
なん	何
なん	男
なんえんそう	南縁草
なんおく	何億
なんぐ	南宮
なんぐう	南宮
なんげ	難解
なんこうぼう	南光坊
なんじ	難字
なんじょ	南女
なんじょう	南条
なんせん	南鮮
なんせんぶしゅう	南贍部洲
なんぜんまんおく	何千萬億
なんとしりつとしょかん	南砺市立図書館
なんばじゅうこう	難波重工
なんばねぎ	難波葱
なんばら	南原
なんびん	南蘋
なんぷう	南風
なんぼくてい	楠木庁
なんぽ	南蒲
なんぽちめいこう	南浦地名考
なんぽんてん	南方天
なんまんぶ	何万部
なんりょう	南鐐
なーが	龍王
なーじきー	名付け
にい	新居
にいき	新城
にいごうがわ	新井郷川
にいのつぼね	二位局
にいはり	新墾
にいるぴと	二色人
にうじまじょう	丹生島城
におい	臭い
におうもんどおり	仁王門通
におないびん	牛奶氷
におもて	二表
にかいどう	二階堂
にかわ	膠
にがいがさ	二蓋笠
にき	仁木
にきょう	二矯
にぎはやひ	饒速日命
にぎめだな	海藻店
にぎり	新切
にく	疾
にくじき	肉食
にくぶ	肉部
にこん	而今
にごりごがわ	濁河川
にし	西
にしうら	西浦
にしおぐ	西尾久
にしかわ	西川
にしき	錦
にしきえ	錦江
にしきお	錦生
にしきだこじゅうろうかげたつ	錦田小十郎景竜
にしきめがね	錦眼鏡
にしきゅうしゅう	西九州
にしこう	西高
にしござみこし	西御座神輿
にししららおろ	西白漘
にしたなか	西田中
にしたまし	西多摩市
にしちゃやがい	にし茶屋街
にしでら	西寺
にしとう	西棟
にしとも	西友
にしとんない	西富内
にしながれ	西流
にしなりてつどう	西成鉄道
にしにっぽり	西日暮里
にしのうら	西浦
にしのうらししょ	西浦支所
にしのおか	西の丘
にしのみやあやは	西宮綾羽
にしまちすじ	西町筋
にしむくさむらい	西向く士
にしむら	西村
にしゆるぎ	西万木
にしんすう	二進数
にしんほう	二進法
にじのへび	虹蛇
にじはくぎん	虹白銀
にじゅうきゅう	二重弓
にじゅうろくにち	廿六日
にじゆう	廿
にじりぐち	躙口
にせ	二才
にせかがく	偽科学
にせはくしゃく	偽伯爵
にせんだみつお	二千田光雄
にた	仁田
にちうりてれび	日売テレビ
にちこう	日光
にちなん	日南
にちゅう	二中
にちりんかめん	日輪仮面
にっか	日果
にっけいじゃすだっくへいきんかぶか	日経ジャスダック平均株価
にっけんそうほんしゃ	株式会社日健総本社
にっしき	日式
にった	新田
にったいっか	新田一家
にっちさんぎょう	ニッチ産業
にっちしじょう	ニッチ市場
にっちゅうせんそう	日中戦争
にっちょめ	西留
にっぱしがわ	日橋川
にっぽんいち	日本一
にっぽんはつじょう	日本発条株式会社
にっぽんれき	日本暦
にてんいちりゅうみだれぎり	二天一流乱れ斬り
にとういちじん	二刀一陣
にとういっせん	二刀一閃
になう	担う
ににぎのみこと	邇邇芸命
にのみや	二宮
にのむら	二ノ村
にひむろうたげ	新室楽
にびいろへび	鈍色蛇
にほ	匂
にほん	日本
にほんえあしすてむ	日本エアシステム
にほんかい	日本海
にほんこうぎょうきかく	日本工業規格
にほんこうくうじゃぱん	日本航空ジャパン
にほんこく	日本国
にほんこくけんぽう	日本国憲法
にほんさんぎょうきかく	日本産業規格
にほんしゅわ	日本手話
にほんしょうぎ	日本将棋
にほんしんわ	日本神話
にほんじんはなぜせんそうへとむかったのか	日本人はなぜ戦争へと向かったのか
にほんのげきぶついちらん	日本の劇物一覧
にほんのどくぶついちらん	日本の毒物一覧
にほんはりすとすせいきょうかい	日本ハリストス正教会
にぼう	二防
にゅうかびょう	乳化病
にゅうきょ	入渠
にゅうしんのじゅつ	入心の術
にゅうどう	入道
にゅうのまた	丹生俣
にゅーげーむ	七大罪遊戯
にゅーとんりきがく	ニュートン力学
にょ	女
にょいかぎ	如意鉤
にょいきんこぼう	如意金箍棒
にょいしんせん	如意真仙
にょいん	女陰
にょぜがもん	如是我聞
にょぜめ	如是女
にょらいぼう	如来法
にょろやくにょでん	如露亦如電
により	似寄
にら	睨
にれいさん	爾霊山
にわか	俄
にんいしょぶん	任意処分
にんかたびらー	忍カタビラー
にんぎょのず	人魚圖
にんげん	人間
にんげんかんけい	人間関係
にんげんしょうぎ	人間将棋
にんげんせいしんりがく	人間性心理学
にんこ	人狐
にんしき	認識
にんしつもんしょう	忍室文勝
にんしゅりけん	忍シュリケン
にんじ	仁治
にんじゃいかずち	忍者雷
にんじゃいちばんしょうぶとう	忍者一番勝負刀
にんじゃいちばんとう	忍者一番刀
にんじゃげきあつとう	忍者激熱刀
にんじゃせん	忍者線
にんじゃのめいよをまもるかい	忍者の名誉を守る会
にんじゃれっぷう	忍者烈風
にんじゅ	仁寿
にんたりてぃ	忍タリティ
にんちこうどうりょうほう	認知行動療法
にんな	仁和
にんなん	仁安
にんにん	人々
にんぷ	人夫
にんぷうき	忍風鬼
にんりゅうざん	忍龍斬
にんれつざん	忍烈斬
ぬいがさ	縫笠
ぬいぐるみ	使い魔
ぬえ	鵺
ぬくいがわ	貫井川
ぬけみのじゅつ	抜身之術
ぬさ	幣
ぬし	主
ぬす	偸
ぬすっとやど	盗人宿
ぬなくらふとたましき	沼名倉太珠敷
ぬなくらふとたましきのみこと	沼名倉太玉敷命
ぬばかま	奴袴
ぬま	沼
ぬまいけ	沼池
ぬりや	塗屋
ぬるで	勝軍木
ぬれえん	濡れ縁
ねえ	姐
ねおしゃんろん	ネオ翔龍
ねぎ	禰宜
ねぎし	根岸
ねくろふぃりあ	死体愛好癖
ねこ	猫
ねこぐるま	猫車
ねこはんてん	猫飯店
ねこや	猫夜
ねじぬき	子ジヌキ
ねっしょうごはんこんぶそうようかん	熱傷後瘢痕部掻痒感
ねっしりゅう	熱子竜
ねっすい	熱水
ねっとう	熱湯
ねつかくへいき	熱核兵器
ねつきかん	熱機関
ねつしょり	熱処理
ねつしん	熱心
ねつぞう	捏造
ねつぼうそう	熱暴走
ねつれつかんげき	熱烈貫戟
ねとり	子酉
ねぬなわ	根蓴菜
ねねこ	在子
ねのおみ	根臣
ねのび	子延
ねのふかいき	根の深い木
ねぶ	合歓
ねまつりあけ	寝祭明
ねむ	寝夢
ねむ	瞑
ねむくない	眠くない
ねりまくり	練馬繰
ねん	念
ねんしゃ	念写
ねんしんまおう	鯰震魔王
ねんねんだん	捻捻弾
ねんねんだんみだれうち	捻捻弾乱れ打ち
ねんぱく	念白
ねんぽう	念法
ねんらい	年來
ねんれい	年齢
ねーべるかっぺ	霧の頭巾
のいえ	新
のう	囊
のうか	苗鹿
のうがみ	農神
のうぎょうかくめい	農業革命
のうぎょうのかみ	農業神
のうぎょそんなどほけんいりょうをためのとくべつそちほう	農漁村等保健医療を為の特別措置法
のうさぎょうよう	農作業用
のうさんぎょそんじょせいのためのこくさいでー	農山漁村女性のための国際デー
のうせん	膿栓
のうぜい	納税
のうど	濃度
のうらんそう	膿襴相
のうりん	農林
のおるとあめりか	北亜墨利加
のかた	野方
のかたがわ	野方川
のきじゃばら	軒蛇腹
のぎ	芒
のくとふぁみりあ	夜の眷属
のぐち	野口
のこ	遺
のこぎり	鋸
のこしがね	遺し金
のこししょ	能古支所
のこるもの	遺
のざませいやくかぶしきがいしゃ	野座間製薬株式会社
のしま	野島
のじま	野島
のすたるぢゃあ	郷愁
のそ	納所
のぞ	望
のぞ	臨
のぞみ	希
のたま	宣
のたま	曰
のたまわ	曰
のち	後
のちのち	後葉
のちのよ	後葉
のでっぽう	野鉄砲
のど	異境
ののし	罵
ののみや	野宮
のび	野火
のぶ	伸
のべざお	延棹
のぼ	上
のぼの	能煩野
のぼり	幟
のぼりのすけ	登助
のぼる	升
のぼる	襄
のみ	鑿
のむら	野村
のむらもとに	野村望東尼
のもと	野本
のや	蓬
のらねこ	野良猫
のり	法
のりこ	のり子
のりひら	憲平
のりひろ	憲熙
のりまさ	乗加
のりもと	徳元
のりもと	毛利教元
のろ	呪
のろし	烽火
のろしかいせん	狼煙開戦
のわき	野分
のんだ	喫んだ
のんばら	沼原
のーとれいやー	脳人レイヤー
のーべるかがくしょう	ノーベル化学賞
のーべるしょう	ノーベル賞
のーべるぶんがくしょう	ノーベル文学賞
のーべるへいわしょう	ノーベル平和賞
はい	孛
はい	敗
はい	輩
はいけい	背景
はいげんしゅ	肺原種
はいせき	排斥
はいたせいぎょ	排他制御
はいどこう	杯戸港
はいどちょう	杯戸町
はいどろ	灰泥
はいならし	灰均し
はいね	灰音
はいのう	胚囊
はいぱーうるとらのっくせんぽう	超ウルトラノック戦法
はいふぁん	海皇
はいふぁん	海防
はいみん	海明
はいめんうち	背面撃ち
はいもごよ	匍匐委蛇
はいよう	佩用
はいらん	排卵
はうすますたー	寮長
はうんど	犬
はおうくろすせいれつざん	刃王クロス星烈斬
はおうけんくろすせいばー	刃王剣十聖刃
はおうせいれつざん	刃王星烈斬
はおうそうせいざん	刃王創星斬
はおうばくえんぐれんざん	刃王爆炎紅蓮斬
はおうばっとばす	破王バットバス
はおうゆうじょうざん	刃王友情斬
はおちー	好吃
はか	圖
はか	墳墓
はか	謀
はか	議
はかいこうせん	墓射光線
はかいししゃちょう	墓石社長
はかいしんさらまんですどらごん	破壊神サラマンデスドラゴン
はかいのしとじゃんぬ	破壊の使徒ジャンヌ
はかいりょく	墓射力
はかた	博多
はかたえきごじっかわせん	博多駅五十川線
はかたぎおんやまかさ	博多祇園山笠
はかたどいまちゆうびんきょく	博多土居町郵便局
はかたならやゆうびんきょく	博多奈良屋郵便局
はかたひめでぃあな	博多姫ディアナ
はかな	波奏
はかま	袴
はかり	光
はかりごと	計
はがいと	飯垣内
はがね	刃金
はがね	鋼
はがねたか	鋼鷹
はがねのもうぎゅう	鋼の猛牛
はがんざんてつけん	破岩斬鉄拳
はぎわら	萩原
はぎわらけんた	萩原健太
はぎわらまこと	萩原眞
はく	帛
はくあい	博愛
はくう	白雨
はくえ	白衣
はくおうがくいん	白凰学院
はくき	伯奇
はくきかぐらすず	伯奇神楽鈴
はくきじんじゃ	伯奇神社
はくぎん	白銀
はくげい	白鯨
はくさん	白山
はくし	白士
はくしょくふんえん	白色噴煙
はくじやく	薄弱
はくじゅ	白寿
はくぞうす	白蔵主
はくたいい	鮊大尉
はくだみ	薄濃
はくち	白雉
はくちゅうむ	白厨夢
はくつるのまい	白鶴の舞
はくはくざん	薄薄斬
はくめんろう	白面郎
はくやまち	箔屋町
はくりせい	剥離性
はくりょくまんてん	迫力満天
はくろうき	白蝋鬼
はぐろけいむしょ	羽黒刑務所
はぐろとくべつきどうけいびたい	羽黒特別機動警備隊
はけん	派遣
はけん	覇権
はけんしゃにん	覇権射忍
はこ	匣
はこざき	箱崎
はこざきぐう	筥崎宮
はこざきししょ	箱崎支所
はこつかい	匣使い
はこと	羽琴
はこまつ	筥松
はこもの	迷宮
はさ	挟
はさま	迫
はさまがわ	迫川
はさみ	鋏
はざかい	端境
はざま	間
はざんこ	巴山虎
はし	奔
はし	暴走
はし	趨
はしうどむら	走水村
はしけ	艀
はしそろえ	箸揃え
はしぞめ	箸初め
はしどちょう	橋戸町
はしひろゆき	橋宏之
はしもとろう	橋本樓
はしよし	箸吉
はしら	柱
はしらま	柱間
はしりいもち	走井餅
はじ	初
はじ	始
はじ	弾
はじか	爆発
はじかみ	薑
はじのいちぞく	土師の一族
はじまりのかみ	創造神
はじまりのつばささくせん	創の翼作戦
はじみ	羞
はじめ	一
はじめ	元始
はじめ	初
はじめ	始
はじめね	始値
はじゃせいじゅうきゅう	破邪聖獣球
はじゃひゃくじゅうけん	破邪百獣剣
はす	荷
はすいと	藕糸
はすいひと	斜い人
はず	筈
はずかし	辱
はずかしめ	辱
はずみ	機
はせ	長谷
はせがみいせき	馳上遺跡
はそうけんはざんもん	覇宗拳波斬門
はそりがさ	端反笠
はた	外
はた	旗
はた	畑
はたえだ	廿枝
はたがしら	旗頭
はたけなか	畑中
はたこ	二十子
はただ	旗田
はたべ	八田部
はたらき	働
はたん	破綻
はだい	波提
はち	捌
はちえいしょう	八英将
はちおうじし	八王子市
はちけんぼりがわ	八間堀川
はちこう	八高
はちごうき	捌号機
はちはちばな	八八花
はちぶてんりゅう	八部天竜
はぢゃや	葉茶屋
はっかい	八骸
はっかく	八角
はっかくういきょう	八角茴香
はっかんぼり	八間堀
はっきょくれんぽう	白極連邦
はっきん	発禁
はっけ	八卦
はっけばし	百家橋
はっこう	発行
はっしょうどう	八正道
はった	八田
はってんじんじゃ	八天神社
はっとりしろうり	服部越瓜
はっとりはんぞう	服部半蔵
はっぽうさいいんちょう	八宝菜院長
はつか	羽束
はつくにしらすすめらみこと	御肇国天皇
はつこう	発行
はつこうご	発行後
はつこひ	初恋
はつせ	長谷
はつせき	初席
はつせべのわかささぎのみこと	長谷部若雀命
はつせべのわかさざきのすめらみこと	長谷部若雀天皇
はつだ	發兌
はつだれ	初垂れ
はつばい	發賣
はつひてい	初日亭
はつめい	發明
はづか	恥
はて	末端
はて	涯諸
はていこうらいげき	覇帝紅雷撃
はていこうらんぶ	覇帝紅嵐舞
はてんこう	破天攻
はとがひら	幸ヶ平
はとば	波止場
はな	花
はないっしん	花一心
はなお	花落
はなおと	花乙女
はなかげゆれるとみず	花影ゆれる砥水
はなかご	花筐
はながさ	花笠
はながた	花形
はなげんしゅ	鼻原種
はなこ	ハナ子
はなこんじょう	花紺青
はなごよみ	華暦
はなし	噺
はなし	話
はなし	説話
はなしろ	鼻白
はなぞの	花園
はなたちばな	花橘
はなたに	花谷
はなつみ	花罪
はなは	甚
はなはだ	甚
はなはなだん	華華弾
はなふだ	花札
はなぶさかい	英会
はなみずきけい	はなみずき圭
はに	波爾
はに	生土
はにつ	土津
はにつかい	埴使い
はぬまーん	白猿神
はね	翅
はねももく	ハネモ目
はねれぎおん	翔レギオン
ははきぎ	帚木
ははじま	母島
はふ	法
はふわう	法王
はぶ	略
はま	浜
はまこう	浜高
はまさきいまづしゅっちょうしょ	浜崎今津出張所
はますい	浜水
はまもと	浜本
はむすたーかんちょう	ハムスター館長
はめつのこくいん	破滅の刻印
はやかわぶんこ	ハヤカワ文庫
はやくちことば	早口言葉
はやさか	早坂
はやし	囃子
はやし	林
はやしだ	林田
はやたろう	早太郎
はやて	疾風
はやてりゅう	疾風流
はやぶさ	隼
はやぶさおー	隼王
はやぶさわけのきみ	速総別王
はやま	葉山
はやみはかせ	速水博士
はやりがみ	流行神
はやりすごろく	時好雙六
はら	原
はら	原野
はら	払
はら	播羅
はらい	祓
はらえ	解除
はらこ	腹子
はらだ	原田
はり	梁
はり	玻璃
はりおうぎ	張り扇
はりけーんどらごん	台風竜
はりねずみ	蝟
はりのうえでてんしはなんにんおどれるか	針の上で天使は何人踊れるか
はりびょう	玻璃瓶
はりま	播摩
はる	日
はる	春
はる	遥
はる	針
はるあたら	春新
はるか	遙
はるか	遠
はるかぜちょう	春風町
はるこ	春子
はるこ	美子
はるずみちょう	春住町
はるつげどり	春告鳥
はると	晴人
はるなが	治元
はるばーど	斧槍
はるびん	哈爾浜
はるやまのかすみおとこ	春山之霞壮夫
はるゆき	春雪
はるよし	春吉
はるらさん	漢拏山
はるる	晴
はれ	霽
はれぎり	ハレ切り
はれこ	波連湖
はろう	波浪
はろー	演算暈
はん	反
はん	攀
はん	韓
はんかくてつどう	阪鶴鉄道
はんかんれき	半還暦
はんきょう	反共
はんきょうさんしゅぎ	反共産主義
はんきょうさんじょうし	板橋三娘子
はんぐうすう	半偶数
はんぐろーばりぜーしょん	反グローバリゼーション
はんけん	版権
はんげき	反撃
はんこう	板行
はんこう	版行
はんこまち	凡虚待
はんごんじゅさつまんだら	反魂呪殺曼荼羅
はんざき	半裂
はんしゃこう	反射光
はんしよく	繁殖
はんじゅ	判授
はんじゅうりょくがい	反重力鎧
はんすけ	半助
はんぞくたいし	斑足太子
はんぞでぃあーつどうめい	反ゾディアーツ同盟
はんたー	狩人
はんたーせいじゅうきゅう	ハンター聖獣球
はんづら	版面
はんでぃすく	反ディスク
はんとう	潘滔
はんどういわ	飯洞岩
はんどらー	管理官
はんなむ	翰南
はんにち	反日
はんにゃじ	般若寺
はんばく	反駁
はんばーかー	半莫迦
はんぱつあたま	半髪頭
はんぴ	半臂
はんぴ	反比
はんぶ	釆部
はんぶっしつ	反物質
はんぷ	頒布
はんぺい	藩屏
はんぽん	版本
はんまん	斑幔
はんめん	半面
はんらんげん	氾濫原
はーどうぇあらんすうせいせいき	ハードウェア乱数生成器
ばい	馬医
ばいおじげんじゅう	バイオ次元獣
ばいおじげんむし	バイオ次元虫
ばいかう	梅香
ばいかくき	梅核気
ばいこうえん	梅光園
ばいこうえんだんち	梅光園団地
ばいしゅん	売春
ばいせいどふどうしょうすうてんすう	倍精度浮動小数点数
ばいなりくうかんぶんかつ	バイナリ空間分割
ばいばいぶんしんけん	倍倍分身拳
ばいぶ	貝部
ばいほう	白芳
ばうえき	貿易
ばか	馬化
ばか	馬鹿
ばかり	計
ばかり	許
ばく	縛
ばく	邈
ばくえんぐれんざん	爆炎紅蓮斬
ばくえんさいゆうき	爆炎彩遊鬼
ばくおんこぞう	爆音小僧
ばくおんぷ	爆音符
ばくげきせん	爆激潜
ばくせいざん	爆勢斬
ばくそうせい	爆走星
ばくとうし	爆闘士
ばくはつぶつたんちけん	爆発物探知犬
ばくひん	幕賓
ばくぶ	麦部
ばくまつ	幕末
ばくようさく	縛妖索
ばくらいは	爆雷破
ばくらてん	獏羅天
ばくりゅうせきかいこうは	爆龍赤塊光波
ばくれつせんきどんしゃいん	爆裂戦記ドンシャイン
ばくれん	莫蓮
ばくろうまち	博労町
ばぐかんりしすてむ	バグ管理システム
ばけがく	化学
ばけみのじゅつ	化身之術
ばしょうせん	芭蕉扇
ばたふらい	運命翅
ばち	撥
ばっきそう	曝気槽
ばっきん	罰金
ばっく	背景
ばっこ	跋扈
ばってき	抜擢
ばっとばすまじんぶたい	バットバス魔人部隊
ばつこ	跋扈
ばつしよう	抜抄
ばていぎん	馬蹄銀
ばとるじゃけっと	戦闘強化服
ばはまこく	バハマ国
ばばぬき	ババ抜き
ばびにく	バ美肉
ばぶ	馬部
ばべる	歌
ばらき	婆羅木
ばらじ	芭羅慈
ばらじいせき	芭羅慈遺跡
ばらじむら	芭羅慈村
ばらじゅうじだん	薔薇十字団
ばらまき	婆羅撒
ばり	罵詈
ばるでる	闘神
ばるばくあ	捕喰作法
ばれいしょ	馬鈴薯
ばろく	馬勒
ばんか	挽歌
ばんかきょう	万華鏡
ばんきじゅう	蛮機獣
ばんきへいうがっつ	蛮機兵ウガッツ
ばんきょ	蟠踞
ばんけんじょ	番犬所
ばんこくき	万国旗
ばんさんかい	晩餐会
ばんしょうじどおり	万松寺通
ばんしょしらべしょ	蕃書調所
ばんしようろう	晩松樓
ばんじ	萬事
ばんじき	飯食
ばんじゅ	盤寿
ばんせいりゅうほう	萬世流芳
ばんせんばんぐみ	番宣番組
ばんぜん	萬善
ばんたくいぜき	番托井堰
ばんとうえん	蟠桃園
ばんとうしょうえ	蟠桃小会
ばんとうたいえ	蟠桃大会
ばんとうどくほうまつ	蛮刀毒泡沫
ばんどーま	蛮ドーマ
ばんのじゅんじ	坂野潤治
ばんばんちゅう	蛮蛮肘
ばんび	蛮美
ばんぶつ	萬物
ばんゆういんりょく	万有引力
ばんゆういんりょくのほうそく	万有引力の法則
ばーさーかー	拳王
ばーじんろーど	生きる道
ばーばおびん	八宝氷
ぱい	南
ぱいかる	白乾児
ぱうだーきす	儀式
ぱおず	包子
ぱじゃま	西洋寝衣
ぱっ	小豆
ぱて	果て
ぱでぃんとんえき	パディントン駅
ぱむー	巴蟆
ぱらだいす	天国
ぱり	巴理
ぱんつぁーぞるだ	機甲兵
ぱんどらぼっくす	絶対領域
ぱーふぇくと	完璧
ひいがわ	樋井川
ひいしじゅうたく	火石住宅
ひえじま	薭島
ひえだ	稗田
ひえん	飛檐
ひえんざん	飛猿山
ひえんだん	飛燕弾
ひえんらい	飛円雷
ひおうぎ	檜扇
ひかく	比較
ひかくさんげんそく	非核三原則
ひかげさわ	日蔭沢
ひかり	光
ひかり	光明
ひかり	閃光
ひかりいし	光石
ひかりがい	光害
ひかりがもりこうとうがっこう	光ヶ森高等学校
ひかりのかみ	光神
ひかりのやかた	偉光会館
ひかりべに	艶紅
ひかる	光
ひかるげんじ	光源氏
ひがさ	檜笠
ひがさ	陽笠
ひがしおぐ	東尾久
ひがしこう	東高
ひがしござみこし	東御座神輿
ひがししょうず	東寒水
ひがししららおろ	東白漘
ひがしすらゔごぐん	東スラヴ語群
ひがしすらゔじん	東スラヴ人
ひがしちゃやがい	ひがし茶屋街
ひがしでら	東寺
ひがしにしみ	東錦見
ひがしにっぽり	東日暮里
ひがしふざかし	東汗
ひがり	翡刈
ひき	将
ひき	弾
ひき	避諱
ひきい	引入
ひきがね	引鉄
ひきがね	銃爪
ひききり	引切
ひきぎ	引木
ひきてぢゃや	引手茶屋
ひきふりそで	引き振袖
ひきゃくじるし	飛脚印
ひきゃくば	飛脚場
ひきやま	曳山
ひきわり	挽割
ひきん	飛禽
ひく	引
ひぐち	樋口
ひけしつぼ	火消し壷
ひげ	髯
ひげどの	髯殿
ひこうでん	披香殿
ひこくにん	被告人
ひこなぎさたけうがやふきあへずのみこと	日子波限建鵜草葺不合命
ひこねみち	彦根道
ひご	卑語
ひご	庇護
ひご	肥後
ひさいらい	飛砕雷
ひさご	瓠
ひさし	壽
ひさし	庇
ひさたろう	久太郎
ひざげんしゅ	膝原種
ひざまづ	跪
ひし	批
ひしおのやかた	醤の館
ひしぬま	菱沼
ひしゃくだししょうまえ	杓田市商前
ひしょう	飛掌
ひしょうきがん	火将危願
ひしょうけん	飛翔剣
ひしょうざん	飛翔斬
ひじ	肘
ひじかた	土方
ひじげんしゅ	肘原種
ひじゅう	匪獣
ひじゅう	比重
ひじゅん	批准
ひじょうじたいせんげん	非常事態宣言
ひすてりぃ	憂鬱症
ひずみ	日澄
ひせいふそしき	非政府組織
ひせき	秘石
ひそう	悲愴
ひたす	只管
ひたり	火垂
ひだ	襞
ひだいはんそく	肥大蕃息
ひだか	日高
ひだすき	火襷
ひだせんぼんのっく	秘打千本ノック
ひだな	火棚
ひちょうえんじん	緋鳥炎陣
ひちょうれつ	飛跳烈
ひちりき	篳篥
ひっきょう	畢竟
ひっさつおうぎはりつけしゅりけん	必殺奥義磔手裏剣
ひっさつかざぐるま	必殺風車
ひっそく	逼塞
ひったいとご	ヒッタイト語
ひっぱく	逼迫
ひつきよう	畢竟
ひつぎ	日続
ひつぎのみこ	太子
ひつじしんでん	未新田
ひつぜん	必然
ひつばおん	弼馬温
ひつよう	必要
ひづめ	蹄
ひていこう	比抵抗
ひてるまる	日照丸
ひてんだん	飛貂弾
ひでよ	淑世
ひでんくじゃくおう	秘伝孔雀扇
ひでんしーるど	秘伝シールド
ひでんちょうちんだいごよう	秘伝提灯ダイゴヨウ
ひでんでぃすくみだれうち	秘伝ディスク乱れ撃ち
ひと	一
ひと	人
ひと	偏
ひと	士
ひと	女性
ひと	彼
ひと	斉
ひと	独
ひと	獨
ひと	等
ひとえ	単
ひとえまぶた	一重まぶた
ひとかい	人貝
ひとかたや	人形屋
ひとがた	人形
ひとことぬしのおおかみ	一言主大神
ひとつ	孑
ひとづて	人伝
ひととき	一時
ひととばら	小鳥原
ひとのき	一軒
ひとみがくえん	妃十三学園
ひとみげんしゅ	瞳原種
ひとむかでのやじり	人むかでの矢尻
ひとよ	一夜
ひとよし	日豊
ひとり	一人
ひとり	一身
ひど	悲道
ひどのらか	ヒドノラ科
ひな	鄙
ひなこ	日南子
ひなたやましゅじゅものがたり	日当山侏儒物語
ひなのし	陽菜野市
ひなわかひめのかみ	雛若媛神
ひなわし	雛鷲
ひねつ	比熱
ひねつようりょう	比熱容量
ひのえんま	飛縁魔
ひのかぐつちのみこと	火之加具土命
ひのき	檜
ひのきないがわ	桧木内川
ひのきはら	桧原
ひのくま	檜垌
ひのもといちのつわもの	日本一の兵
ひのやま	火の山
ひばがえし	飛羽返し
ひばこ	杼箱
ひばし	火箸
ひばしらきっく	火柱キック
ひばりてい	雲雀亭
ひばりまる	日張丸
ひばるひえせん	桧原比恵線
ひびきくれない	響鬼紅
ひびきぐち	響口
ひふくしょう	被服廠
ひぶ	非部
ひぶ	飛部
ひへん	火扁
ひぼう	被帽
ひまだかいちょう	比間田会長
ひまわり	向日葵
ひみつ	秘密
ひみつほじけいやく	秘密保持契約
ひむき	費無忌
ひむろ	氷室
ひめ	姫
ひめいらん	飛鳴乱
ひめがま	姫蒲
ひめたち	姫達
ひめぼうまじゃーみん	姫暴魔ジャーミン
ひもろぎ	神籬
ひゃくいろめがね	百色眼鏡
ひゃくじゅ	百寿
ひゃくふくし	百福士
ひゃくまいおろし	百枚おろし
ひゃくめんき	百面鬼
ひゃっかしゅう	百花羞
ひゃっかじてん	百華事店
ひゃっかせいほう	百花斉放
ひゃっかひょうらん	百火繚乱
ひゃっき	百鬼
ひゃっきまる	百鬼丸
ひやきはやめのみこと	火焼速女命
ひやみず	寒水
ひゅうが	日向
ひゅうがむら	日向村
ひゆか	譬喩歌
ひょう	表
ひょう	雹
ひょうい	兵医
ひょうい	憑依
ひょういつ	飄逸
ひょうか	瓢果
ひょうかそう	氷花箏
ひょうがりゅうじゃしんけん	豹牙流邪心拳
ひょうきゅうみゃく	氷丘脈
ひょうけつじょう	氷結城
ひょうさくき	氷削機
ひょうし	表紙
ひょうしょう	兵商
ひょうじゅんへんさ	標準偏差
ひょうじょう	評定
ひょうじょうかん	評定官
ひょうじん	氷刃
ひょうそ	瘭疽
ひょうたんがた	瓢箪形
ひょうてん	氷点
ひょうのせん	氷ノ山
ひょうひょう	飄々
ひょうぶ	髟部
ひょうほんか	標本化
ひょうぼう	標榜
ひょうりゅう	氷竜
ひょうりんまる	氷輪丸
ひょうろくどんのきなこもち	兵六どんのきなこ餅
ひょうろくどんのよもぎもち	兵六どんのよもぎ餅
ひょっとこ	火男
ひよう	表
ひようほん	飛葉翻
ひようりゅう	飛葉竜
ひようりゅう	飛踊竜
ひら	啓
ひら	開
ひらい	開
ひらいし	平石
ひらいし	避来矢
ひらお	平尾
ひらお	平緒
ひらおかまち	平丘町
ひらおじょうすいまち	平尾浄水町
ひらかわ	平川
ひらがさ	平笠
ひらたゆきえ	平田靱負
ひらちゅう	平中
ひらのまち	平野町
ひりゅうかげきだん	火龍歌撃弾
ひりゅうこん	飛龍棍
ひりゅうこんだいふうしゃ	飛龍棍大風車
ひりゅうしゅうげきは	火龍蹴撃破
ひりゅうどはつてん	火龍怒髪天
ひりゅうはおうけん	飛龍覇皇剣
ひりん	卑吝
ひるあんどん	昼行灯
ひるこ	毘流古
ひるぜん	蒜山
ひれ	鰭
ひれき	披瀝
ひれふり	領巾麾
ひれふりのみね	領巾麾之嶺
ひろ	博
ひろ	広
ひろ	廣
ひろいん	彼女
ひろいん	欲望
ひろくにおしたけかなひのみこ	広国押建金日王
ひろくにおしたけかなひのみこと	広国押建金日命
ひろこ	弘子
ひろさ	広袤
ひろさきどうほこ	広鋒銅矛
ひろし	洋
ひろし	浩
ひろししょ	弘支所
ひろしましょうけんとりひきじょ	広島証券取引所
ひろなり	熙成
ひろのみや	浩宮
ひろはる	大晴
ひろみつ	景光
ひろみみじんじゃ	廣耳神社
ひろめや	広目屋
ひろゆき	博之
ひろゆき	浩之
ひわがえし	飛羽がえし
ひんかくせん	品鶴線
ひんきゃく	賓客
ひんく	貧苦
ひんせん	貧賎
ひんでんこんでんとかんぎき	殯殿魂殿都監儀軌
ひんばーな	貧婆国
ひんひ	嬪妃
ひーろー	英雄
びい	微意
びいる	麦酒
びきょう	美嬌
びくう	媚空
びくこく	比丘国
びこうおう	獼猴王
びこうおう	美猴王
びざい	美材
びしゃもんだい	毘沙門台
びしよう	美妾
びしんこう	鼻唇溝
びじゅつか	美術家
びじんけい	美人計
びせいぶつそう	微生物叢
びぜんこう	美髯公
びそ	鼻祖
びだいかしゅう	毘提訶洲
びっぐふっとのきんぐごん	ビッグフットの筋グゴン
びっこ	跛
びっちゅうしろしょうず	備中白小豆
びっとまっぷがぞう	ビットマップ画像
びと	人
びばい	美唄
びばうし	美馬牛
びぶ	鼻部
びぶん	微分
びぶんほうていしき	微分方程式
びゃくだんし	白檀紙
びゃくやきしだん	白夜騎士打無
びゃくれんきしざんが	白蓮騎士ザンガ
びゃっかい	白海
びゃっこ	白狐
びゃっこいっせん	白虎一閃
びゃっこしんけん	白虎真剣
びゃっこじゅうもんじぎり	白虎十文字斬り
びゃっこはくうじん	白虎白羽陣
びゅうまち	別府町
びゅーてぃふるぞりーまー	ビューティフルゾリー魔ー
びょうか	苗稼
びょうき	病気
びょうどう	廟堂
びょうどうしょうち	平等性智
びょうはく	錨泊
びょうりがく	病理学
びようどう	廟堂
びらん	美爛
びりびり	備離美利
びれい	媚麗
びれい	美麗
びろうげ	檳榔毛
びろーどりこん	ビロード離婚
びんごまち	備後町
びんごまる	備後丸
びんしょう	敏捷
びんびんけん	敏敏拳
びんらん	紊乱
びんろう	嬪郎
びんろうじ	檳榔子
びーびむし	ビービ虫
ぴえろ	道化
ぴくてん	必屈登
ぴたごらすのていり	ピタゴラスの定理
ぴぼっと	軸足移動
ぴんげいにん	ピン芸人
ぴーぱー	琵琶
ぴーまーうぇん	避馬瘟
ふぁいあーどらごん	火炎竜
ふぁいてぃんぐあーまろいど	装甲戦闘ロボット
ふぁいやーさいだいとつげき	ファイヤー砕大突撃
ふぁおすと	拳
ふぁっちょいほうしー	髪菜蠔豉
ふぁみりあ	影同心
ふぁるびんだん	活貧団
ふぁんがん	黄岡
ふぁんくしょん	羽刃
ふぁんたじあ	聖謡譚
ふぁんたすてぃっくかげきざん	ファンタスティック過激気斬
ふぁんたずま	影の国
ふぁんたずまごりあ	幻想の唄
ふぃくさー	黒幕
ふぃなんしえ	金融業者
ふぃりあ	偏愛
ふぃーるど	競技場
ふぃーるど	輪郭
ふぃーるどもにたー	戦場哨戒
ふぃーんど	悪魔
ふい	巫毉
ふいん	府尹
ふういんのしゅりけん	封印の手裏剣
ふうう	風雨
ふううんきしばど	風雲騎士波怒
ふううんまぼろしじょう	風雲幻城
ふうからんぶ	風花乱舞
ふうが	風牙
ふうけん	馮諼
ふうさ	楓沙
ふうじ	風侍
ふうじんごう	風神号
ふうじんれつ	風塵烈
ふうぜんてい	風前亭
ふうそうけんはやて	風双剣翠風
ふうぞくれきし	風俗歴史
ふうたろう	風太郎
ふうと	風都
ふうは	風波
ふうはめいどう	風波鳴動
ふうび	風靡
ふうふうねん	封封念
ふうぶ	風部
ふうぼう	風帽
ふうまこたろう	風魔小太郎
ふうましきょうけん	風魔死鏡剣
ふうましゅれいえん	風魔朱麗焱
ふうまそうざんとう	風魔双斬刀
ふうまむげんじん	風魔霧幻陣
ふうまれっかざん	風真烈火斬
ふうまれっぷうけん	風魔烈風剣
ふうらいにんしゅりけん	風雷忍シュリケン
ふうらいまる	風雷丸
ふうりゅう	風龍
ふうろう	風浪
ふぇありーている	救国奇譚
ふぇありーもすら	妖精モスラ
ふぇいつい	翡翠
ふぇでらりすと	連邦主義者
ふぇにっくす	不死鳥
ふぇにるけとんにょうしょう	フェニルケトン尿症
ふぇりし	妖精
ふぇりしん	妖精族
ふぇーす	顔
ふえ	笛
ふぉれすと	樹海
ふか	深
ふかかぶりがさ	深被り笠
ふかくていせいげんり	不確定性原理
ふかざわ	深澤
ふかしぎげんしょうけんきゅうじょ	不可思議現象研究所
ふかん	俯瞰
ふき	不羈
ふきだいく	吹大工
ふく	含
ふく	復
ふくあん	腹案
ふくおかそとかんじょうどうろ	福岡外環状道路
ふくおかちょう	福岡町
ふくがこうぞう	覆瓦構造
ふくき	復帰
ふくぐうすう	複偶数
ふくさんし	副蚕糸
ふくざわせんせい	福澤先生
ふくし	掘串
ふくしがっか	福祉学科
ふくしまだいいちげんしりょくはつでんしょじこ	福島第一原子力発電所事故
ふくすいふへん	覆水不返
ふくそかんしきかごうぶつ	複素環式化合物
ふくそすう	複素数
ふくだ	福田
ふくちきと	福内鬼外
ふくでんね	福田衣
ふくよう	服膺
ふくらしこ	膨らし粉
ふくりゅう	伏龍
ふくろう	梟
ふくろう	鴟
ふくをう	福翁
ふけ	浮気
ふげんだけ	普賢岳
ふごうびっと	符号ビット
ふざん	釜山
ふし	巫司
ふしぎ	奇異
ふしじん	傅士仁
ふしちょうむそうぎり	不死鳥無双斬り
ふしちょうむそうげき	不死鳥無双撃
ふしみまち	伏見町
ふしゅう	付臭
ふしょ	負黍
ふしん	覆真
ふじ	富士
ふじ	藤
ふじい	藤井
ふじかわさんけい	藤川三渓
ふじがさ	富士笠
ふじがさ	藤笠
ふじきね	臥杵
ふじけ	不二家
ふじさき	藤崎
ふじした	藤下
ふじしまじんじゃ	藤島神社
ふじしょう	藤小
ふじた	藤田
ふじつる	藤蔓
ふじばやし	藤林
ふじみしょぼう	富士見書房
ふじみね	藤峰
ふじみや	藤宮
ふじようはいのぎ	富士遥拝の儀
ふじわらのもとつね	藤原基経
ふすいはっかい	風水八骸
ふせ	拒
ふせ	禦
ふせ	防
ふせんじ	富山寺
ふせんじょうやく	不戦条約
ふそう	鳧藻
ふそん	不遜
ふた	二
ふたえまぶた	二重まぶた
ふたおもて	双面
ふたごあくまかいろ	双生児アクマ回路
ふたごじま	二子島
ふたごぼし	双子星
ふたつちゃやむら	二ツ茶屋村
ふたのき	二軒
ふたば	双翅
ふたまた	二又
ふたまち	二町
ふたり	二人
ふだ	札
ふだいし	傅大士
ふち	淵
ふちゆうい	不注意
ふぢかぎ	藤鎰
ふぢわらうじ	藤原氏
ふつう	普通
ふていげん	不定元
ふていしゅうそ	不定愁訴
ふで	毫
ふで	筆
ふとう	不撓
ふとう	埠頭
ふとうろうどうこうい	不当労働行為
ふときぬ	絁
ふとし	歩斗志
ふとっちょ	肥満女
ふとまきこうりん	太巻き光輪
ふなうたい	舟謡
ふなさく	船作
ふなてのこたろう	船手の小太郎
ふなど	船戸
ふなゆうれい	船幽霊
ふね	船
ふね	艦
ふねのふびとえさか	船史恵尺
ふねのふびとえさか	船恵尺
ふねほこ	船鉾
ふぶ	缶部
ふぶ	阜部
ふぶき	吹雪鬼
ふぶきねぇ	フブキ姉ぇ
ふぼ	父母
ふみ	典
ふみのり	文憲
ふみばあ	フミ婆
ふみひつ	表函
ふらく	富樂
ふらくたるはうす	自己相似荘
ふらの	富良野
ふらんきーさかい	フランキー堺
ふらんけん	不亂劔
ふる	動
ふる	揮
ふるい	篩い
ふるいずみ	古泉
ふるかわ	古川
ふるこがらすこうえん	古小烏公園
ふるこがらすまち	古小烏町
ふるこんとろーるえんかうんと	全力管制戦闘
ふるさと	故郷
ふるた	古田
ふるち	古市
ふるびら	古平
ふるほしちょう	降星町
ふるほん	古本
ふれいむどらごんぞく	炎竜族
ふれーむもんだい	フレーム問題
ふわしゅにん	不破主任
ふわじゅうぞう	腑破十臓
ふん	吻
ふん	扮
ふんごう	吻合
ふんしゃくどくげきは	噴灼毒撃波
ふんぞうえ	糞掃衣
ふんとうどりょく	奮闘土力
ふんぽん	粉本
ふんまん	憤懣
ふんれい	奮励
ふーいーぱん	和義幇
ふーじんごんす	虎鯨公司
ふーる	愚者
ぶあく	武悪
ぶいしょうりたて	武威勝利盾
ぶえい	武衛
ぶくし	掘串
ぶけよう	武家様
ぶこうりゅう	武鋼竜
ぶしゅへんかん	部首変換
ぶしょうひげ	無精髭
ぶじこれきにん	無事是貴人
ぶじん	武刃
ぶじんへんげ	武人変化
ぶそうそうこうはっとり	武装装甲八鳥
ぶそくてい	武則帝
ぶっけんてきせいきゅうけん	物権的請求権
ぶっしつ	物質
ぶっしゃり	仏舎利
ぶっせつ	仏刹
ぶっそらい	物徂徠
ぶったい	物体
ぶつぶつがわ	ぶつぶつ川
ぶつり	物理
ぶつりがく	物理学
ぶつりがく	物理學
ぶつりがくしゃ	物理学者
ぶつりしよ	物理書
ぶつろん	物論
ぶとうかい	舞踏会
ぶどうとう	ブドウ糖
ぶどうりゅうほう	ブドウ龍砲
ぶどーまじんしゅう	ブドー魔人衆
ぶみんかん	撫民官
ぶらい	符礼
ぶらいかん	無頼漢
ぶらいだる	馬勒
ぶらっくすみす	刀鍛冶
ぶらっくどらごんぞく	黒竜族
ぶらっくらびっと	黒兎
ぶらっでぃしゃーりぃ	血染めのシャーリィ
ぶり	風流
ぶりがんでぃ	鎧姫
ぶりゅんひるで	装甲戦姫
ぶるすかめんて	乱暴に
ぶるぶれーど	震々刀
ぶるーどらごんぞく	青竜族
ぶれい	無礼
ぶれいくれりーず	完全開放
ぶれいどだんす	剣舞
ぶれーんまっぷ	脳波分析
ぶろうかん	武牢関
ぶろっけいどしーど	封じ込めの種
ぶろぶのまくいん	ブロブの膜イン
ぶろんずないと	青銅騎士
ぶん	分
ぶん	文
ぶんおう	文応
ぶんか	分果
ぶんかけい	文科系
ぶんかのひ	文化の日
ぶんかんむすめしゅう	文官娘衆
ぶんき	文亀
ぶんけいさん	文計算
ぶんこうゆうごう	文工融合
ぶんさい	文彩
ぶんしかんりょく	分子間力
ぶんしやう	文章
ぶんしよう	文章
ぶんしん	文身
ぶんしんまきゅう	分身魔球
ぶんぶんふぁんこぶし	分分ファン拳
ぶんぽうりせき	分崩離拆
ぶんめい	文明
ぶんめいろん	文明論
ぶんやのまひとちぬ	文室真人智努
ぶんり	文理
ぶんりか	分離果
ぶんりゃく	文暦
ぶんりゅう	分留
ぶんりゆうごう	文理融合
ぶんろく	文禄
ぷうこおぴえん	不彀本
ぷらかしーゆ	プラカシー油
ぷらちな	白金
ぷらねっつ	惑星
ぷりんせす	兎姫
ぷれでぃけっと	述語論理
ぷれふぇ	知事
ぷれりゅーど	前奏曲
ぷろてくとら	護国卿政治
ぷろとたいぷ	初号機
ぷーる	普溜
へい	昺
へいいんようじょう	丙寅洋擾
へいか	陛下
へいけ	平家
へいこうき	平衡機
へいさき	閉鎖器
へいし	斃死
へいし	瓶子
へいしむれ	倍以之牟礼
へいしむれーる	歇伊武禮児
へいしゅこうか	瓶首効果
へいじん	平人
へいせい	平成
へいせいじだい	平成時代
へいぜい	平生
へいぞう	平蔵
へいたんびん	黒糖氷
へいていしき	聘定式
へいほうすう	平方数
へいゆえ	黒月
へいりつ	並立
へいりょく	兵力
へいわ	平和
へかとんけいる	神なる御手
へき	璧
へきかみ	日置上
へきがん	壁龕
へきぎょく	碧玉
へきこせい	碧湖精
へきそ	碧素
へくせんぶりーど	魔女の眷属
へくせんりったー	異端騎士
へこすけ	屁古助
へこにせ	兵児二才
へざ	戸座
へそげんしゅ	臍原種
へっど	頭
へど	吐
へやてん	部屋店
へり	縁
へるとしゅとらっせ	英雄煌路
へんい	偏倚
へんいたい	変異態
へんいでんりゅう	変位電流
へんかん	変換
へんきょくてん	変曲点
へんくい	很貴
へんくわ	變化
へんげ	変化
へんげにんしゅりけん	変化忍シュリケン
へんげんがいしょうびーざっく	変幻鎧将ビーザック
へんげんじざいこんいかづちまる	変幻自在棍イカヅチ丸
へんさん	編纂
へんしょう	貶称
へんそせん	編組線
へんとう	籩豆
へんとうけっせき	扁桃結石
へんとうせんし	扁桃栓子
へんりーらくちん	ヘンリー楽珍
へんろがさ	遍路笠
へゔぃさいどのかいだんかんすう	ヘヴィサイドの階段関数
べいかちょう	米花町
べいこくこっかきかくきょうかい	米国国家規格協会
べいじゅ	米寿
べいぶ	皿部
べいぶ	米部
べいぶんがく	米文学
べいりん	貝林
べうえい	苗裔
べか	可
べき	冪
べきぶ	糸部
べくとるけいさんき	ベクトル計算機
べくとるせき	ベクトル積
べすてぃえーる	中世動物寓意集
べっとう	別当
べっぷ	別府
べつ	鼈
べつぎ	別義
べつし	蔑視
べつたう	別當
べにかげ	紅影
べにがららくだ	紅殻駱駝
べにきば	紅牙
べにぎつね	紅狐
べにぎょくずい	紅玉髄
べにこうじ	紅柑子
べには	紅葉
べにみどろこう	ベニミドロ綱
べにや	紅屋
べにや	紅野
べひもす	破壊獣
べふ	別府
べふえき	別府駅
べふだんち	別府団地
べるぎーまる	白耳義丸
べるくふりーと	城姫
べるりん	別林
べん	便
べんか	卞和
べんがる	辨加拉
べんき	弁喜
べんきやう	勉強
べんけい	弁慶
ぺがすすざ	ペガスス座
ぺすと	黒死病
ぺっと	騎士
ぺりかんびん	ペリカン便
ぺんぎんだん	ペンギン弾
ぺーじ	頁
ぺーとるびゆるぐ	伯徳禄堡
ほあかり	火明
ほいと	布衣裳
ほいほい	回回
ほう	砲
ほう	袍
ほう	鉋
ほうあん	保安
ほうえ	法衣
ほうえい	宝永
ほうえい	蓬瀛
ほうえきほう	縫腋袍
ほうか	砲架
ほうかつりえき	包括利益
ほうがく	方角
ほうがく	邦楽
ほうがくちめい	方角地名
ほうがくぶ	法学部
ほうがんびいき	判官贔屓
ほうき	宝亀
ほうきこく	宝髻国
ほうぎぞく	法儀族
ほうぎょくのもり	宝玉の森
ほうぎり	方限
ほうげん	保元
ほうこう	咆哮
ほうこう	哮吼
ほうこう	砲口
ほうこうせいたいき	砲口制退器
ほうこくじんじゃ	豊国神社
ほうざんけんぎょう	宝山検校
ほうし	法師
ほうしゃ	砲車
ほうしゃのう	放射能
ほうしょうごん	宝荘厳
ほうしょうじのにゅうどうさきのかんばくだいじょうだいじん	法性寺入道前関白太政大臣
ほうしょうめだる	褒賞メダル
ほうじ	宝治
ほうじ	砲耳
ほうじよ	幇助
ほうすう	鳳雛
ほうぜうがふち	放生淵
ほうそぎ	柞木
ほうそくせんだんそうじん	崩側旋断掃刃
ほうぞう	宝蔵
ほうちょう	法帖
ほうてき	放擲
ほうとう	奉答
ほうとく	宝徳
ほうどう	芳堂
ほうどうせんたー	報道センター
ほうどうぶ	報道部
ほうび	砲尾
ほうふつ	彷彿
ほうふつ	髣髴
ほうべん	方便
ほうほうだん	咆咆弾
ほうまい	包埋
ほうまおう	鵬魔王
ほうまん	穂満
ほうみ	法味
ほうみょうおしょう	法明和尚
ほうよう	抱影
ほうらいがん	蓬莱眼
ほうりがわ	祝子川
ほうりゅうこくうざん	鳳龍虚空斬
ほうれき	宝暦
ほうれき	邦暦
ほうろ	宝璐
ほうろうけんしくいーんきらー	放浪剣士クイーンキラー
ほおおちば	朴落葉
ほおずみ	朴炭
ほおづき	鬼灯突
ほおべにたろう	頬紅太郎
ほおり	穂織
ほおれい	頬齢
ほか	他
ほか	外
ほかじょう	外城
ほくえつてつどう	北越鉄道
ほくえつなんせん	北越南線
ほくえつほくせん	北越北線
ほくそう	北総
ほくちん	北鎮
ほくと	北都
ほくぶきゅうしゅう	北部九州
ほぐいのかみ	保食神
ほぐん	補群
ほけんがくぶ	保健学部
ほけんふくしがくぶ	保健福祉学部
ほこ	伐
ほこ	鉾
ほことん	矛盾
ほこりしゅし	埃種子
ほご	反故
ほさ	法者
ほし	地球
ほし	惑星
ほし	星
ほし	犯人
ほしいまま	恣
ほしう	歩驟
ほしうめばち	星梅鉢
ほしかわはかせ	星川博士
ほしがやはい	星ヶ谷杯
ほしきせき	星輝石
ほしきりまる	星斬丸
ほしころぜえ	懐酒
ほしとりで	星砦
ほしのほんだな	地球の本棚
ほしはかせ	星博士
ほしひじき	干ひじき
ほしぶどう	干し葡萄
ほしやまし	星山市
ほしやまはかせ	星山博士
ほしゅうごう	補集合
ほしよみ	星読
ほすう	補数
ほすせり	火闌
ほせい	保穧
ほそくび	細頚
ほその	細野
ほたていわ	火立岩
ほたる	蛍
ほっかいどうてつどう	北海道鉄道
ほっかん	北韓
ほっくるしゅう	北倶盧洲
ほっけえ	法華会
ほっしょうじ	法性寺
ほっしょうじがさ	法性寺笠
ほっそう	法相
ほっそうしゅう	法相宗
ほったん	発端
ほっとすとーん	保温石
ほっぽうてん	北方天
ほでぃすく	捕ディスク
ほでり	火照
ほでりのみこと	火照命
ほと	殆
ほと	陰
ほと	陰部
ほとけら	仏ケ後
ほととぎす	杜鵑
ほととぎす	牡鵑
ほとほ	殆
ほとん	殆
ほど	程
ほねいた	骨板
ほねいたがね	骨板金
ほねかね	骨金
ほねがみまる	骨餓身丸
ほねのしたり	骨のシタリ
ほのお	焔
ほのおいっせん	炎一閃
ほのおしゅう	炎衆
ほのおのぱんち	鳳仙牙
ほのおのや	炎の矢
ほのおびと	炎人
ほばしら	檣
ほひつ	輔弼
ほびっと	歩人
ほびー	玩具
ほふく	匍匐
ほむじわけのみこと	誉津別命
ほむじわけのみこと	誉牟治別命
ほむだ	品太
ほむだのみよ	品蛇御世
ほむだわけのみこと	品蛇和氣命
ほむちわけのみこ	本牟智和気王
ほむら	火群
ほむら	炎
ほむらのさと	火群の里
ほむんくるす	人造人間
ほむんくるす	人造生命
ほもしすちんにょうしょう	ホモシスチン尿症
ほや	寓生
ほら	保良
ほらたはかせ	洞田博士
ほらー	恐怖
ほらー	火羅
ほりえきいち	堀江帰一
ほりかわ	堀河
ほりもの	彫り物
ほれもの	耄者
ほろくさ	保呂草
ほろび	滅
ほろび	滅亡
ほろむいがわ	幌向川
ほわいとどらごん	白竜姫
ほわいとどらごんぞく	白竜族
ほわいとらびっと	白兎
ほん	洋書
ほん	紅
ほんい	本意
ほんがん	本願
ほんぎょういんでんほうくんごとつにちじょうこじ	本行院殿法勲語咄日盛居士
ほんけがえり	本卦還り
ほんさい	本妻
ほんしゅう	本州
ほんしょうぎ	本将棋
ほんせんじ	品川寺
ほんたい	本體
ほんたて	本立
ほんだ	本多
ほんだな	本棚
ほんだれ	本垂れ
ほんだわけのみこと	品陀和気命
ほんぢじょう	本治城
ほんとう	真
ほんばいとぅあんずびん	紅白団子氷
ほんばこ	本箱
ほんふるく	本古来
ほんま	本間
ほんまち	本町
ほんみず	本水
ほんもん	本文
ほんやく	翻訳
ほんやく	飜訳
ほんやく	飜譯
ほんやくしょ	飜訳書
ほんやくしよ	飜訳書
ほんらい	夲來
ほんりゅう	本留
ほんろう	翻弄
ぼあら	菩阿羅
ぼう	坊
ぼう	昴
ぼう	矛
ぼうえき	貿易
ぼうが	忘我
ぼうきかく	某企画
ぼうきゃく	忘却
ぼうぐわい	望外
ぼうこうげんしゅ	膀胱原種
ぼうこん	暴魂
ぼうしょう	傍生
ぼうすいちゅう	紡錘虫
ぼうずうお	坊主魚
ぼうそう	房総
ぼうそうこうていえぐぞす	暴走皇帝エグゾス
ぼうそうしょうぼうしゃ	暴走消防車
ぼうそうれんけつせいめいたいばるぎげにあ	暴走連結生命体バルギゲニア
ぼうだて	榜立
ぼうとく	冒涜
ぼうぶ	矛部
ぼうぶ	黽部
ぼうぼう	暴暴
ぼうましん	暴魔神
ぼうまじゅう	暴魔獣
ぼうまじょう	暴魔城
ぼうまたいていらごーん	暴魔大帝ラゴーン
ぼうまはかせれーだ	暴魔博士レーダ
ぼき	簿記
ぼくきち	卜吉
ぼくしゅ	墨守
ぼくじょう	卜定
ぼくつうじげんかい	朴通事諺解
ぼくとつ	朴訥
ぼくや	牧家
ぼけわら	木瓜原
ぼっけ	北方
ぼでぃますしすう	ボディマス指数
ぼとるねっくこうか	ボトルネック効果
ぼれい	牡蛎
ぼろのいず	ボロノイ図
ぼんど	接着剤
ぼんなか	盆中
ぼーと	城内船
ぼーと	短艇
ぽえむ	母恵夢
ぽっぽ	鉄道
ぽぴゅらーおんがく	ポピュラー音楽
ぽむぷ	喞筒
ぽろしりだけ	幌尻岳
ぽんぷり	本解
ぽーたる	転送装置
ぽーらんど	波蘭
まい	枚
まい	真衣
まい	舞
まいか	舞香
まいかい	玫瑰
まいきょ	枚挙
まいくび	舞首
まいこまいひと	毎戸毎人
まいごせんたー	迷子集会
まいしん	邁進
まいじし	舞獅子
まいすたー	工匠
まいすたー	指揮者
まいだし	馬出
まいづる	舞鶴
まいねん	毎年
まいはだ	米肌
まいひょうご	舞兵庫
まいへん	毎編
まいまいだ	舞舞打
まいまいちょう	舞舞跳
まいまつばら	舞松原
まう	白
まえ	前
まえぞの	前園
まえの	前野
まえはま	前浜
まえみや	前宮
まえんげつ	魔偃月
まおあるちえ	卯二姐
まおあーるじぇ	卯二姐
まおう	魔王
まおうまぐろな	魔王マグロナ
まおうりゅうたつろっと	魔皇竜タツロット
まおしき	魔王式
まおまお	猫猫
まか	任
まか	罷
まかいきし	魔戒騎士
まかいじゅ	魔戒樹
まかいのもり	魔界の森
まかいほうし	魔戒法師
まかいりゅう	魔界竜
まかびるしゃな	摩訶毘盧遮那
まかもう	魔化魍
まがぐらき	禍蔵鬼
まがだ	摩竭陀
まがつばさ	禍翼
まがぱどん	禍破呑
まがまがあーくべりある	禍々アークベリアル
まがり	勾
まがり	鈎
まき	万樹
まき	槙
まき	真木
まき	魔姫
まき	魔忌
まき	魔鬼
まきびし	撒火紙
まきむく	纏向
まぎ	紛
まぎ	麻伎
まくうかんごく	魔空監獄
まくうくうかん	魔空空間
まくべ	間久部
まくべつ	幕別
まくらごと	枕言
まくわうり	真桑瓜
まぐさ	秣
まぐなしきたねがしま	馬具那式タネガシマ
まぐま	真熊
まぐろすてーき	鮪素停育
まけ	捲
まけいしゅらてん	摩醯首羅天
まけんがいしょうきるまんてぃす	魔剣鎧将キルマンティス
まけんしじん	魔拳士ジン
まけんしんかんとりん	魔剣神官トリン
まげ	髷
まこと	実
まこと	真
まこと	真実
まこまない	真駒内
まこまないがわ	真駒内川
まこも	真菰
まごころ	赤心
まごめはんじろきゅうり	馬込半白胡瓜
まさ	勝
まさ	將
まさ	正
まさ	雅
まさあり	方存
まさいてんしょうこう	魔砕天照光
まさかげん	マサカ源
まさこ	勝子
まさこ	正子
まさこないしんのう	正子内親王
まさこばあさん	マサ子ばあさん
まさたか	政隆
まさとし	雅俊
まさみ	雅美
まさゆき	政之
まさよ	政代
まさよ	雅代
まさる	勝
ました	間下
ましょうこうりん	魔装降臨
ましら	猿
ましらのじんない	ましらの甚内
ましん	魔神
ましん	魔進
ましんがん	機関銃
ましんがんだんす	機銃の踊り
ましんどーる	機巧少女
ましーなりー	機工師
ましーん	殺人機
まじ	交
まじ	本気
まじ	真剣
まじ	錯
まじき	間敷
まじっくらんど	魔法の国
まじないごと	呪い事
まじは	交
まじま	真島
まじめ	眞面目
まじゅう	魔獣
まじゅうそうこう	魔獣装甲
まじょさんぼう	魔女参謀
まじわ	交
まじんかん	魔神館
まじんけん	魔神剣
まじんていとく	魔神提督
ます	升
ます	真洲
ますかれーど	仮面武闘会
ますくえんじぇる	仮面天使
ますこ	繁子
ますさきおおはし	真州崎大橋
ますたー	召喚主
ますたー	店主
ますだ	増田
ますみ	真澄
ません	魔泉
まそゆう	真麻木綿
まぞく	魔族
まぞひずむ	被虐性欲
また	亦
またこれ	亦是
またま	全間
まだむやん	楊夫人
まだらまく	斑幕
まだんきー	魔弾キー
まち	市
まち	泥地
まちあいぢゃや	待合茶屋
まちうち	町内
まちず	魔地図
まちだただえい	町田忠栄
まちどしより	町年寄
まちや	町屋
まちゅうへいびーび	魔虫兵ビービ
まちょう	魔鳥
まちわらし	街童子
まっちゃあずき	抹茶小豆
まっとう	完
まっはどらいばーほのお	マッハドライバー炎
まつ	奉
まつ	松
まつ	祀
まつうら	松浦
まつえい	末裔
まつえもん	松右衛門
まつこ	松子
まつご	末期
まつざき	松崎
まつした	松下
まつしま	松島
まつた	全
まつたろう	松太郎
まつと	全
まつど	松土
まつど	松戸
まつびさいき	末尾再帰
まつびばし	松日橋
まつびよびだしさいてきか	末尾呼出し最適化
まつみのる	松稔
まつむら	松村
まつらさよひめ	松浦佐用姫
まつらのかがみ	松浦鏡
まつりか	茉莉花
まづ	先
まてきめか	魔的メカ
まてつこ	魔鉄粉
まと	的
まと	纏
まとのひめ	円野比売
まど	牖
まどうきしうるざーど	魔導騎士ウルザード
まどうぐ	魔導具
まどうこ	魔洞湖
まどうしんかんめーみぃ	魔導神官メーミィ
まどうばぎんが	魔導馬銀牙
まどうばばりきおん	魔導馬バリキオン
まどぎわぞく	窓際族
まどく	真毒
まどこ	真渡子
まな	霊力
まないたいわ	俎岩
まながみ	眼神
まなこゐ	眼居
まなご	真名子
まなご	砂子
まなしき	末那識
まなはじめ	真魚始め
まなむすめ	愛娘
まにぐるま	マニ車
まにま	随
まね	真似
まねきん	模型
まの	真野
まばたき	瞬き
まひと	真人
まぶ	麻部
まほうしゃしんびじゅつぶ	魔法写真美術部
まほうしょくぶつまんどらぼうや	魔法植物マンドラ坊や
まほうせき	魔宝石
まほうせんししりーず	魔法戦士シリーズ
まほうねこすもーきー	魔法猫スモーキー
まほうのかみ	魔法神
まほうりき	魔法力
まぼく	魔木
まぼろしかぶと	幻カブト
まぼろしのげっこう	幻の月光
まぼろしへんげ	幻変化
まま	儘
まま	私
まみ	看
まみ	雌狸
まみや	間宮
まむしづかじょう	馬伏塚城
まも	衛
まもう	摩耗
まもりしもの	守りし者
まもりのかぜ	防りの風
まや	真夜
まやくたんちけん	麻薬探知犬
まゆ	繭
まゆこ	真由子
まゆみ	檀
まゆみ	真由美
まよ	真夜
まよわのきみ	目弱王
まりあ	飼主
まりあ	麻璃亜
まりえ	真梨絵
まるがめひかん	丸亀樋管
まるがめまち	丸亀町
まるしあ	マルシア
まるしま	丸島
まるた	丸田
まるたですく	丸田デスク
まるにかさ	丸に笠
まるにじゅうのじ	丸に十の字
まるわにひとつこうほね	丸輪に一河骨
まれ	稀
まろ	円
まろうじょ	魔老女
まわりみち	紆路
まを	奏
まを	申
まん	漫
まんえい	滿盈
まんえん	万延
まんえん	蔓延
まんがじょうほうし	漫画情報誌
まんがんじ	満願寺
まんぐぉびん	芒果氷
まんごろう	万吾樓
まんじゅ	万寿
まんじゅ	満寿
まんじゅう	饅頭
まんじゅうがさ	饅頭笠
まんじょうめ	万城目
まんたにたかこ	萬谷宣子
まんだのつつみ	茨田
まんねんろう	迷迭香
まんのすけ	萬之助
まんぴつ	漫筆
まんぶんりつ	万分率
まんようけん	万葉県
まーくあっぷげんご	マークアップ言語
まーげん	胃袋
まーじ	魔札使
まーめいど	人魚
みい	美衣
みいづ	御稜威
みいら	木乃伊
みお	緒
みお	美緒
みおこ	美緒子
みおつくし	澪標
みおやもとすおおみかみ	御親元素大御神様
みか	美加
みか	美香
みかお	甕雄
みかおみ	甕臣
みかくりのみや	甕栗宮
みかげ	御影
みかさがわ	御笠川
みかた	味方
みかづきがい	ミカヅキ凱
みかづきぜろ	ミカヅキ零
みかづきどうめい	三日月同盟
みかど	帝
みかど	御門
みかみ	三上
みかめ	三瓶
みかもやま	三毳山
みかわしまく	三河島区
みが	研
みがらじけん	身柄事件
みがらひきあげ	身柄引上げ
みきたればみなこれやこのしん	見來皆是野狐身
みきのつかさ	造酒司
みぎた	右田
みぎり	砌
みぎわ	皐
みく	未来
みく	深空
みくりや	御厨
みぐい	身食い
みけ	御食
みこ	女王
みこ	姫
みこ	巫女
みこ	御子
みこ	王
みこけいしょうのぎ	巫女継承の儀
みさきはら	岬原
みさごまる	鶚丸
みささぎ	山陵
みささぎ	御陵
みささぎ	陵
みしきち	御敷地
みしまうど	三島独活
みしまのあいののみささぎ	三嶋藍野陵
みしゃぐじ	御左口神
みしろ	御城
みす	失敗
みすがた	威儀
みすずがくえん	みすず学苑
みすてり	推理小説
みすみ	三角
みず	水
みず	自
みずか	自
みずかがみいなりごんげん	水鏡稲荷権現
みずかがみこうせん	水鏡光線
みずかみ	水上
みずがきのみや	水垣宮
みずがめざ	みずがめ座
みずき	水城
みずたに	水谷
みずぢゃや	水茶屋
みずなす	水なす
みずのかみ	水神
みずのまく	水の幕
みずのりゅう	水の龍
みずはら	水原
みずはわけのみこと	水歯別命
みずへん	水扁
みずへんげ	水変化
みずほ	瑞穂
みずわた	水渡
みそ	味噌
みそぎ	禊
みそぎはふり	御衣木祝
みそぎはふり	御衣祝
みそぎほうり	御衣着祝
みそぢまりやとせ	三十八歳
みそのおばやし	御薗小林
みそまやま	御杣山
みそみも	御衣御裳
みぞくひ	溝杙
みぞくひひめ	溝樴姫
みぞれ	霙
みた	来
みたか	三鷹
みたて	見立
みだいがわ	御勅使川
みだり	慢
みち	径
みち	路
みち	道
みち	道路
みちあえのまつり	道饗祭
みちこ	美智子
みちの	道野
みちのくのくに	陸奥国
みちはら	道原
みちび	導
みちびき	導鬼
みちや	道弥
みっしゃくりきし	密迹力士
みっつくみあわせかげたちばな	三つ組み合わせ陰橘
みっつたちばな	三つ橘
みつ	三
みつ	御津
みついしじんじゃ	三石神社
みつえ	光恵
みつえ	御杖
みつかい	御使い
みつかげ	光影
みつぎ	献物
みつぎがわ	御調川
みつこうほね	三つ河骨
みつしゅ	密須
みつち	蛟龍
みつば	密羽
みつめこうえん	三眼猿猴
みつめのきゅうえんぼう	三つ眼の旧猿坊
みつやひらのすい	三ツ矢平野水
みつよせがさ	三つ寄せ笠
みつらぼしかたながたり	三つら星刀語り
みづち	大虬
みづはわけのきみ	水歯別王
みづはわけのみこと	水歯別命
みづほじどうしゃせいさくじょ	みづほ自動車製作所
みてぐら	御幣
みてら	御寺
みであ	美丁亜
みとしのかみ	御歳神
みとち	美止知
みどり	水土利
みどりのおばさん	緑のおばさん
みどりのしっぷう	碧の疾風
みどりのひ	みどりの日
みどりのや	緑舎
みどりのれっぷう	碧の烈風
みどろ	美土路
みな	皆
みな	看做
みな	見做
みないなぎさ	御薬袋渚
みなかぜだい	南風台
みなかたとみ	南方刀美
みなかたとみのみこと	御名方刀美命
みなぎ	漲長
みなぎ	美袋
みなくちがさ	水口笠
みなごろし	鏖
みなごろしてんし	皆殺し天使
みなごろしのけんか	尽劉の剣花
みなしろ	御名代
みなづき	六月
みなづき	水無月
みなと	水な門
みなと	海口
みなとひがし	港東
みなみ	南
みなみい	南井
みなみかんとう	南関東
みなみきゅうしゅう	南九州
みなみきゅうほうじまち	南久宝寺町
みなみこうえん	南公園
みなみせんじゅ	南千住
みなみせんば	南船場
みなみちょうせん	南朝鮮
みなみとうじんしょうがっこう	福岡市立南当仁小学校
みなみとりしま	南鳥島
みなみのうおざ	みなみのうお座
みなみのかんむりざ	みなみのかんむり座
みなみはた	南畑
みなみひとつがおか	南一ヶ岡
みなみほんまち	南本町
みなもと	源
みなもととおる	源融
みなもばしり	水面走り
みのしま	美野島
みのすみ	箕角
みのばじょう	蓑姥尉
みのり	法
みはか	御陵
みはしらのうずのみこ	三貴子
みはた	御旗
みはら	三原
みひたき	御火炬
みふね	三船
みぶがわ	三峰川
みぶん	身分
みほと	御陰
みほとせ	三百年
みぼうじん	未亡人
みまきいりひこいにえのみこと	御真木入日子印恵命
みまきいりひこいにゑのみこと	御眞木入日子印惠命
みまきいりびこいにえのすめらみこと	御間城入彦五十瓊殖天皇
みまつ	美松
みまつひこかえしねのみこと	御真津日子可恵志泥命
みまつひこかゑしねのみこと	御眞津日子訶惠志泥命
みまわりぐみ	ミマワリ組
みみげんしゅ	耳原種
みみずく	蚓喰
みみはら	耳原
みむら	三村
みむろ	御室
みもろやま	御諸山
みやがわ	宮川
みやぎだい	宮城大
みやけみや	御炊宮
みやこ	都
みやこいなか	都鄙
みやこじ	都路
みやざき	宮崎
みやした	宮下
みやずひめ	美夜受比売
みやだいこ	宮太鼓
みやぢもりまかつたけゐのうし	宮道護目勝建胆大人
みやの	宮野
みやのうら	宮の浦
みやのうら	宮浦
みやびお	風流男
みやま	御山
みやまえ	宮前
みやもとちょう	宮元町
みやもり	宮森
みゅんすたーのはんらん	ミュンスターの反乱
みゅーじかるえいが	ミュージカル映画
みゅーず	編集者
みゆ	未夢
みゆき	幸
みゆき	御幸
みゆき	美幸
みゆきぞく	みゆき族
みゆきどおり	みゆき通り
みょうかんざつち	妙観察智
みょうこういん	妙香院
みょうしゅ	妙手
みょうしん	明心
みょうじょうのでいんばると	明星のデインバルト
みょうじんこ	明神湖
みょうだい	名代
みょうぶ	名簿
みょうぶ	命婦
みょうぼうかんもん	明経勘文
みよ	御代
みよう	妙
みようもく	名目
みよく	魑翼
みらい	未来
みらいぶ	未来部
みらくるめいかー	奇跡の怪盗
みらーじゅ	蜃気楼
みるく	牛乳
みんかん	民間
みんしよく	眠食
みんじ	民事
みんじほう	民事法
みんみんけん	眠眠拳
みんりつこくじかい	明律国字解
みーこ	ミー子
みーちぇりあ	凍漣の雪姫
むうど	情調
むかいかわぐち	向川口
むかいじましゅうれん	向島秀蓮
むかし	昔
むかでやま	百足山
むかばきやま	行縢山
むかりゅうはっけっきゅう	無顆粒白血球
むかわ	鵡川
むがいりゅう	無骸流
むきかがく	無機化学
むきつ	夢橘
むぎすけ	麦助
むぎぞう	麦蔵
むぎた	麦太
むぎのしん	麦之進
むくいばし	椋橋
むけい	夢閨
むけい	無形
むげんしょう	無限小
むげんしょうらいは	夢幻招来波
むげんのしとゔぉっふぁ	無限の使徒ヴォッファ
むげんりゅう	無間龍
むげんるーぷ	無限ループ
むげんれっぱ	無限烈破
むげんれんささいまじゅう	無限連鎖サイマ獣
むこうしょうは	無効消波
むこうしん	向新
むこうじま	向島
むこうづけ	向付
むこのみなと	務古水門
むささび	武者鎖火
むさし	武蔵
むさんそうんどう	無酸素運動
むし	蟲
むしゃとうそうがんだむ	武者刀槍頑駄無
むしょうの	虫生野
むしよせかざは	虫寄せ風葉
むしろ	筵
むじき	無食
むじなづか	狸塚
むじんこうくうき	無人航空機
むじんこうくうじゅうじしゃしけん	無人航空従事者試験
むすう	無数
むすう	無數
むすめ	女
むせいあい	無性愛
むせいふきょうさんしゅぎしゃどうめい	無政府共産主義者同盟
むそうせいばー	無双セイバー
むそじまりよとせ	六十四歳
むそぢまりみとせ	六十三歳
むそとせ	六十歳
むち	無智
むちうち	笞打
むつのくに	陸奥国
むてきしょうぐん	無敵将軍
むてむか	無手無冠
むてんいちりゅう	無天一流
むとんじやく	無頓着
むな	空
むなし	曠空
むなびれ	胸鰭
むねげんしゅ	胸原種
むねさだ	棟貞
むねっち	無熱池
むねなが	宗長
むねなが	棟良
むねもと	宗元
むひょうけん	霧氷剣
むび	夢寐
むへん	無邊
むま	夢魔
むまぞく	夢魔族
むむぬちはんたー	股引半套
むめい	無名
むめいけんきょむ	無銘剣虚無
むやみ	無暗
むよく	無慾
むら	村落
むらい	村井
むらこう	村高
むらさき	紫
むらさきしきぶ	紫式部
むらさきのうえ	紫の上
むらさめまる	叢雨丸
むらさわ	村沢
むらた	村田
むらやま	村山
むりよく	無力
むろ	室
むろまちばくふ	室町幕府
むろまる	室丸
むろらん	室蘭
むーあらんど	荒地
むーだん	巫堂
むーんぺた	月下手
めい	鳴衣
めいあんきょうかいせん	明暗境界線
めいおう	明応
めいおうじるふぃーざ	冥王ジルフィーザ
めいかいまとうし	冥界魔闘士
めいきょう	鳴響
めいきょうしすい	明鏡止水
めいこうかん	名教館
めいしつ	明瑟
めいじ	名辞
めいじしんぐう	明治神宮
めいじじだい	明治時代
めいじたいていへいか	明治大帝陛下
めいじま	姪島
めいじゅう	冥獣
めいじゅうじん	冥獣人
めいじゅうじんしていおう	冥獣人四底王
めいず	迷路
めいずめーかー	迷宮建造師
めいたい	名タイ
めいたんていしんどろーむ	名探偵症候群
めいだい	命題
めいだいけいさん	命題計算
めいぢ	明治
めいてい	酩酊
めいとく	明徳
めいのはま	姪の浜
めいのはまえき	姪浜駅
めいのはまししょ	姪浜支所
めいびちほうじむしょ	明美地方事務所
めいびん	明敏
めいふごちょうはいぞびる	冥府伍長ハイゾビル
めいふへいぞびる	冥府兵ゾビル
めいゆ	明喩
めいよ	名誉
めいよきそん	名誉毀損
めいよきそんざい	名誉毀損罪
めいれき	明暦
めかりじんじゃ	和布刈神社
めかんのん	銘観音
めかんふー	銘功夫
めがふれあばーすと	超竜火球弾
めがみほうり	売神祝
めくら	盲
めくらさが	盲捜
めくらじま	目倉島
めぐ	環
めぐ	輪廻
めぐ	運
めぐみ	惠
めぐみ	芽萌
めぐり	匝り
めぐろ	目黒
めしべ	雌蕊
めしゃもじん	女石神社
めじそ	芽紫蘇
めたふえしす	流転骨牌
めたら	牝誑
めたるちぇんじゃー	機竜化士
めだま	眼球
めちゃくちゃ	滅茶苦茶
めちゃたろう	メチャ太郎
めっかいのたて	滅壊の盾
めっしんぐげん	滅身具現
めった	滅多
めつご	滅後
めておぶれす	竜火球
めで	愛
めでぃあ	団
めでぃけあ	医療保険
めでたい	芽出度い
めでたしめでたし	芽出度芽出度
めでゅーさしんどろーむ	メデューサ症候群
めと	娶
めとろんちゃ	眼兎龍茶
めど	目処
めどりのきみ	女鳥王
めのう	瑪瑙
めのうまさただ	女王将唯
めのと	乳母
めのと	傅
めのとご	乳母子
めばかり	匁許
めふぃらすれっぷうさい	冥府羅州烈風斎
めもりーれこーど	追想日誌
めらんこりい	憂鬱
めんえきぐろぶりん	免疫グロブリン
めんぶ	面部
もいわやま	藻岩山
もう	儲
もう	申
もう	白
もうか	孟夏
もうかじゅうげき	猛火獣撃
もうぎゅうだいかいてんほう	猛牛大回転砲
もうぎゅうほう	猛牛砲
もうし	猛士
もうしょう	蒙頌
もうせつ	妄説
もうせん	毛氈
もうそう	莽草
もうそうそう	妄想送
もうどくがいしょうですこーぴおん	猛毒鎧将デスコーピオン
もうね	舞根
もうぶ	毛武
もうぶ	网部
もうもうぶんしんへん	毛猛分身変
もうり	毛利
もうりたんていじむしょ	毛利探偵事務所
もうりょう	魍魎
もうろう	朦朧
もうろく	耄碌
もえぎ	萌黄
もがみ	最上
もがりのもり	殯の森
もく	目
もくさ	木叉
もくさい	牧西
もくてき	目的
もくてきへんすう	目的変数
もくどく	黙読
もくのじぎり	木の字斬り
もくひけん	黙秘権
もくぶ	目部
もぐさ	艾
もさく	莫作
もじ	捩
もじ	文字
もじことば	文字詞
もじようきごう	文字様記号
もず	毛受
もずく	海雲
もずの	毛受野
もた	凭
もち	用
もち	糯
もちうるちせい	糯粳性
もちだ	持出
もちづき	望月
もちづき	餅搗き
もちづきのあちよめ	望月ノア千代女
もちづきはかせ	望月博士
もちめえ	持前
もちやもんどう	餅屋問答
もちろん	勿論
もぢからだいだんえん	モヂカラ大弾円
もっ	以
もっき	木記
もっこう	木高
もっとも	尤
もっぱ	専
もつ	以
もつとも	最
もつに	もつ煮
もつぱ	専
もつぱ	專
もてあそ	弄
もと	下
もと	前世
もと	固
もと	干
もと	戻
もと	本
もと	求
もとい	基
もとき	元木
もとき	幹
もとだてきたいせき	元立北遺跡
もとつね	本根
もとづ	基
もとづき	基
もとで	元手
もとどり	髻
もとのぶ	元陳
もとはる	職治
もとひさ	元寿
もとまち	元町
もとまち	本町
もとめ	需
もとやしろ	元社
もとより	元倚
もなお	モナオ
もの	物
もの	者
ものいみ	斎
ものがたり	伝説
ものがたり	物語
ものしり	藻知
もののふ	武士
ものみ	物見
もふし	裳伏
もぶ	僕
もみがら	籾殻
もむらがわ	百村川
もめん	木綿
もも	桃
もも	百
ももあまりいそぢまりみとせ	一百五十三歳
ももあまりはたちまりみとせ	一百二十三歳
ももあまりはたちまりよとせ	一百二十四歳
ももあまりみそぢまりななとせ	一百三十七歳
ももあまりみそとせ	一百三十歳
ももあまりむそぢまりやとせ	一百六十八歳
ももあまりむとせ	一百六歳
ももか	百華
ももそ	百襲
ももちはま	百道浜
ももの	桃乃
ももふね	百船
もや	身舎
もや	靄
もやう	摸樣
もよお	催
もらっ	賜
もり	森
もり	銛
もりお	森尾
もりおうちょう	杜王町
もりきょううたひめ	森京詞姫
もりさんちゅう	森三中
もりした	森下
もりたかっぷ	森田杯
もりたのかみ	守達神
もりだいないき	森大内記
もりひら	守平
もりやじんじゃ	洩矢神社
もりやだいじん	守屋大臣
もりやま	森山
もりんじのかま	茂林寺釜
もるしつりょう	モル質量
もろ	諸
もろおか	諸岡
もろが	諸鹿
もろこし	唐土
もろちか	師親
もろつ	室津
もろもろ	諸
もんがい	門外
もんく	文句
もんく	武闘家
もんしん	紋身
もんじ	文字
もんすたーとれーなー	魔獣錬磨師
もんぜき	門跡
もんだい	問題
もんてかるろほう	モンテカルロ法
もんぶ	門部
もんま	門間
もんもん	悶々
もんもん	紋々
もーもーだ	母母打
やいば	刃
やいば	少女
やう	樣
やうや	漸
やえうらうめ	八重裏梅
やえくまねのみこと	八重隈根命
やかた	屋形
やかはえひめ	矢河枝比売
やがみ	矢神
やきいれせい	焼入れ性
やきねのみこと	八杵命
やきゅう	野球
やきゅうかめん	野球仮面
やきょく	夜曲
やぎざ	やぎ座
やぎじま	野羊島
やぎもんどのすけもとのぶ	八木主水佑元信
やぎゅうえいだん	野牛鋭断
やぎゅうがさ	柳生笠
やぎゅうれつだん	野牛烈断
やく	訳
やくい	薬医
やくいん	薬院
やくいんいふくまち	薬院伊福町
やくいんしんかわ	薬院新川
やくおとしのふで	厄落ノ筆
やくかがくか	薬科学科
やくがくか	薬学科
やくがくぶ	薬学部
やくさのいかずち	八雷神
やくざい	薬剤
やくし	八櫛
やくしょ	役所
やくしん	八草伸
やくそく	約束
やくにん	官吏
やくのう	薬嚢
やくば	役場
やくひん	薬品
やくぶ	龠部
やくぶつらんよう	薬物乱用
やくぼん	約盆
やくめ	役目
やくやま	養久山
やぐち	矢口
やぐら	櫓
やぐらにんせんぷう	やぐら忍旋風
やけ	自棄
やけやまやじらう	焼山彌次郎
やげん	薬研
やさか	矢板
やさかとめ	八坂刀売神
やさかのすず	八栄鈴
やざ	や座
やざき	矢崎
やざわ	矢沢
やし	弥四
やし	薬師
やし	野士
やしき	邸
やしま	屋島
やしまひがしまち	屋島東町
やしゃがみ	夜叉神
やしゃまる	夜叉丸
やしろ	矢代
やしろ	社
やじま	矢島
やす	寧
やすうじ	易氏
やすすけ	康資
やすね	安値
やすはら	安原
やすひこ	保彦
やすみ	安息
やすらい	夜須礼
やせいかいほうにんれつざん	野性解放忍烈斬
やそ	耶蘇
やそかみ	八十神
やそじ	八十
やそじまりみとせ	八十三歳
やそぢまりみとせ	八十三歳
やた	彌太
やたがらす	八咫烏
やたのわきいらつめ	八田若郎女
やたら	矢鱈
やちほこのかみ	八千矛神
やつきり	谷切
やつふさすぎ	八ツ房スギ
やてんりん	夜天輪
やどり	舎
やながわ	柳川
やなぎ	柳
やなぎおんな	柳女
やなぐひ	胡簶
やなしょ	簗所
やなはし	簗橋
やなはら	柳原
やなべ	岩滑
やなめがわ	簗目川
やぬしおしおたけおごころのみこと	屋主忍男武雄心命
やのくま	岩熊
やのくまぐち	岩熊口
やのむねがわ	家棟川
やはぎ	矢作
やひろしろちどり	八尋白智鳥
やぶい	薮医
やぶくぐり	藪潜
やぶくすし	藪薬師
やま	山
やま	山車
やまうちさん	山内さん
やまうらてんじん	山浦天神
やまえるふ	山エルフ
やまお	山尾
やまおろし	山颪
やまかわせんせい	山川先生
やまぎし	山岸
やまこ	玃
やまごや	山小舎
やまさちひこ	山幸彦
やまざき	山崎
やまし	山師
やました	山下
やましみず	山泉
やまたのおろち	八岐大蛇
やまだ	山田
やまち	山地
やまちゃん	山ちゃん
やまと	倭
やまと	大和
やまと	日本
やまとおおくにたま	大和大國魂
やまとこうえんまえ	倭公園前
やまとさるがくよざ	大和猿楽四座
やまとさんじゃくきゅうり	大和三尺胡瓜
やまとたけるのみこと	倭建命
やまとたけるのみこと	日本武尊
やまとちゅうざいしょまえ	倭駐在所前
やまとととひももそひめ	倭迹迹日百襲姫命
やまとととひももそひめのみこと	倭迹迹日百襲姫命
やまととはやかんあさじはらまくわしひめ	倭迹速神浅茅原目妙姫
やまとびつ	倭櫃
やまねこ	貍
やまのうえのおくら	山上憶良
やまのべ	山邊
やまふじ	山藤
やまぶき	山吹鬼
やまぶし	山伏
やまべのあかかに	山辺赤蟹
やまべのあかひと	山部赤人
やまほととぎす	山杜鵑
やまもと	山本
やまや	山谷
やまんば	山姥
やみ	黒暗
やみあかにんじゃー	闇アカニンジャー
やみえき	闇駅
やみおうぎる	闇王ギル
やみきぞくですたー	闇貴族デスター
やみぎりし	闇斬師
やみしょうぐんざんだー	闇将軍ザンダー
やみしょうにんびずねら	闇商人ビズネラ
やみなぎのつるぎ	闇薙の剣
やみのかみ	闇神
やみのくろぞう	闇の黒蔵
やみのもうじゃ	闇の亡者
やみはかせまーぶろ	闇博士マーブロ
やみひめ	闇姫
やみまじんあいすらー	闇魔人アイスラー
やみゆうき	闇ユウキ
やもめ	寡
やや	稍
やゆ	揶揄
やよい	弥生
やらい	夜來
やり	技術
やりいかいっせん	槍烏賊一閃
やりいかとっかん	槍烏賊突貫
やりほうおう	槍鳳凰
やわ	軟
やわたのやぶしらず	八幡の藪知らず
やんちょう	揚州
やんる	晏如
やーうぇん	雅文
やーんなー	屋号
ゆいしきさんじゅうじゅ	唯識三十頌
ゆいのめのほととぎす	結いの目の不如帰
ゆう	木綿
ゆう	郵
ゆうかいえいへいさいまかおす	幽界衛兵災魔カオス
ゆうかずら	木綿鬘
ゆうかんきっさあにまーれ	有閑喫茶あにまーれ
ゆうき	幽鬼
ゆうき	汐希
ゆうき	結城
ゆうき	雪季
ゆうぎり	由宇霧
ゆうげんせきにん	有限責任
ゆうこ	優子
ゆうこ	夕子
ゆうこ	木綿子
ゆうこうとし	友好都市
ゆうさく	勇作
ゆうさんそうんどう	有酸素運動
ゆうざんくん	熊山君
ゆうしで	木綿垂
ゆうしゅどうぶつ	有鬚動物
ゆうしょく	有職
ゆうしょくふんえん	有色噴煙
ゆうじ	右時
ゆうじ	雄治
ゆうじょうこまんだー	友情コマンダー
ゆうじんかん	友人間
ゆうすい	酉水
ゆうせい	遊星
ゆうせいみんえいか	郵政民営化
ゆうぜい	疣贅
ゆうそん	挹損
ゆうだすき	木綿襷
ゆうちゅうかい	唯昼怪
ゆうと	雄斗
ゆうとう	雄闘
ゆうとじゅく	遊人塾
ゆうはな	木綿花
ゆうばんかい	唯晩怪
ゆうびじん	有尾人
ゆうびん	郵便
ゆうびんきょく	郵便局
ゆうぶ	邑部
ゆうぶ	酉部
ゆうべ	夕
ゆうまおうさらまんです	幽魔王サラマンデス
ゆうまさいまじゅう	幽魔サイマ獣
ゆうみん	悠明
ゆうめい	有名
ゆうよく	遊弋
ゆうりよく	有力
ゆうれいはかせ	幽霊博士
ゆうわてき	宥和的
ゆえ	故
ゆえちえんぴん	月見氷
ゆえん	由縁
ゆかり	縁
ゆき	雪
ゆきえ	雪絵
ゆきくま	雪くま
ゆきの	雪乃
ゆきまど	雪窓
ゆぐどらしる	世界創生
ゆぐどらしる	異界召喚
ゆげた	弓削田
ゆざこ	湯迫
ゆしゅつ	輸出
ゆじゅう	油獣
ゆす	強請
ゆすはら	梼原
ゆすらうめ	梅桃
ゆずえ	弓末
ゆずりうけ	譲受け
ゆずりうけにん	譲受人
ゆずりわたしにん	譲渡人
ゆせいかん	輸精管
ゆたか	温
ゆたか	裕
ゆたか	豊
ゆづ	讓
ゆにこーん	聖獣
ゆにゆう	輸入
ゆびきたすしゃかい	ユビキタス社会
ゆびわかんじょ	指輪官女
ゆふべ	夕
ゆみ	優美
ゆみはり	弓張
ゆみはりがくいん	弓張学園
ゆみはりし	弓張市
ゆみみみまつり	弓耳祭
ゆめ	夢
ゆめ	幻界
ゆめかなうしらほし	夢叶白星
ゆめがたり	夢語
ゆめがたりかたなのうたげ	夢語刀宴會
ゆめこう	夢高
ゆめの	夢野
ゆめのやしゅじん	夢廼舎主人
ゆめほしけ	夢星家
ゆめみさい	夢見祭
ゆもと	湯元
ゆらい	由來
ゆりえ	ゆり江
ゆりこ	由利子
ゆる	弛
ゆるが	忽
ゆるがせ	忽
ゆるしわしない	ユルシワ竹刀
ゆるとら	超王党派
ゆゑ	故
ゆんぐふらう	銀乙女
ゆーざーちゅうしんせっけい	ユーザー中心設計
よあけのうた	夜明けのうた
よう	用
よう	癰
ようい	庸医
ようかいおうじょ	妖怪王女
ようかいだいきゅうでん	妖怪大宮殿
ようかいだいまおう	妖怪大魔王
ようがく	洋学
ようがくしやりゆう	洋学者流
ようがっこう	洋学校
ようき	妖鬼
ようき	陽気
ようげんみっしばんきゅりあ	妖幻密使バンキュリア
ようこ	擁子
ようこ	陽子
ようさいせいめいたいあのまろがりす	要塞生命体アノマロガリス
ようさん	養蚕
ようし	陽子
ようしぎょくじょうびょう	羊脂玉浄瓶
ようしゅう	邕州
ようしゅうかん	鷹愁澗
ようしゅりけん	妖シュリケン
ようしょ	洋書
ようすけ	洋介
ようすこうだいはんてん	揚子江大飯店
ようせい	夭逝
ようせいのはこ	妖精の匣
ようせんきょう	夭仙郷
ようそういっぺん	鷹爪一変
ようちょう	涌潮
ようちょう	膺懲
ようていいりえす	妖帝イリエス
ようてき	陽翟
ようひめ	妖姫
ようぶ	羊部
ようへい	傭兵
ようへい	壅蔽
ようま	妖魔
ようまい	楊瑁
ようまきば	妖魔牙
ようや	漸
ようゆう	葉祐
ようようちん	楊柳鎮
ようりきたいせん	羊力大仙
ようろういん	養老院
よかわ	横川
よかん	余寒
よきさまりあびとのほう	善きサマリア人の法
よきまつりごと	善政
よぎけい	技藝
よぎり	夜霧
よく	欲
よく	翼
よく	能
よくか	翼果
よくじき	欲食
よくばり	翼罵詈
よくふか	翼鱶
よくまろ	余九麿
よけい	予型
よげん	預言
よげんしゃ	預言者
よこいっせん	横一閃
よこいと	緯糸
よこがみ	軸
よこしま	邪曲
よこしまなるおう	邪なる王
よこたさん	横田さん
よこたわるさくら	横たわる櫻
よこぼりさんすけ	横堀三助
よこまちすじ	横町筋
よこもじ	横文字
よごと	吉事
よごふりょう	予後不良
よさみ	依網
よし	好
よし	由
よしえ	佳枝
よしおか	吉岡
よしかわ	吉川
よしぐち	吉口
よしだ	吉田
よしてる	義輝
よしとみ	吉富
よしなが	吉永
よしの	芳野
よしはる	義春
よしひさ	良久
よしひで	良秀
よしふさ	義房
よしふみ	恵文
よしみ	芳美
よしみ	誼
よしむね	令宗
よしむら	吉村
よしむらけじゅうたくいどやかた	吉村家住宅井戸屋形
よしむらけじゅうたくおもや	吉村家住宅主屋
よしむらけじゅうたくきゅうなや	吉村家住宅旧納屋
よじん	余燼
よすう	余数
よそ	余処
よそじまりみとせ	四十三歳
よそぢまりいつとせ	四十五歳
よそぢまりここのとせ	四十九歳
よたもの	与太者
よち	余地
よっ	仍
よっ	依
よっつのほしのかびん	四つの星の花瓶
よつ	依
よつ	由
よどがわおおはし	淀川大橋
よぬ	四沼
よぬのおみ	余奴臣
よねのいわい	米の祝い
よは	夜半
よはい	余輩
よはね	約翰
よぶこ	呼名
よぶこ	呼子
よみかへ	讀返
よみがな	漢字
よみがはま	夜見ヶ浜
よみまる	黄泉丸
よもぎ	蓬
よもぎう	蓬生
よものうら	四方浦
よやくご	予約語
より	依
より	撚り
よりうどばし	寄人橋
よりすえ	頼季
よりついせん	撚り対線
よりつき	寄付
よる	夜
よろ	宜
よろい	甲
よろい	鎧
よろいがに	鎧蟹
よろいじんらい	鎧迅雷
よろこ	悦
よろこび	歓喜
よろんけんぽう	与論献奉
よわい	齢
よん	英
よんかちょう	四ヶ町
よんけんじん	四賢神
よんじぇ	寧堤
よんじゅうのたち	四重の太刀
よんのむら	四ノ村
よんほんね	四本値
よーろつぱ	欧羅巴
らいあき	来秋
らいがいっせん	雷牙一閃
らいけん	雷剱
らいげきざん	雷撃斬
らいげきでぃすく	雷撃ディスク
らいこう	雷吼
らいごう	雷剛
らいごうだん	雷剛弾
らいさま	雷様
らいざー	起動者
らいしゅう	来週
らいしんざんいいん	雷神山医院
らいじ	雷侍
らいじゅう	雷獣
らいじん	雷神
らいじんやみがけびゃっこ	雷刃闇駆白虎
らいせんす	御免状
らいだーまんじがため	ライダー卍固め
らいちょう	来朝
らいてい	雷霆
らいでんかえんうずまき	雷電火炎渦巻き
らいでんかえんじざいぎり	雷電火炎自在斬り
らいでんさんだんがえし	雷電三段返し
らいでんざんこう	雷電残光
らいでんざんこうごれんづき	雷電残光五連突き
らいでんのまい	雷電の舞い
らいでんひしょうぎり	雷電飛翔斬り
らいでんほうみだれうち	雷電砲乱れ撃ち
らいと	光
らいどう	礼堂
らいはとうげ	来葉峠
らいばる	好敵手
らいぶ	あの時
らいぶ	耒部
らいめいかん	雷瞑館
らいめいきしばろん	雷鳴騎士破狼
らいめいけんいかずち	雷鳴剣黄雷
らいめいけんひかりまる	雷鳴剣ヒカリマル
らいめいだん	雷鳴弾
らいらいじゅう	来来獣
らいらく	磊落
らいりゅう	雷龍
らおさんちあんこくさいしょうぼうじょう	ラオ三江国際商貿城
らおすちゅうごくてつどう	ラオス中国鉄道
らおふおいえ	老仏爺
らくえんくらぶ	落演倶楽部
らくげきけん	絡撃拳
らくとりすか	ラクトリス科
らくらいじごく	落雷地獄
らぐなろく	放課後戦争
らごう	羅号
らさじま	ラサ島
らしゃたいし	羅車太子
らじある	進
らすとがーでん	錆の園
らせつ	羅刹
らせつじょ	羅刹女
らせんのたち	螺旋の太刀
らっきー	幸運
らてんご	ラテン語
らでん	螺鈿
らとう	螺塔
らなん	羅南
らばーず	初恋薊
らびりんす	迷宮
らびりんすすとーん	迷宮の輝石
らびりんとす	迷宮塔
らぶ	愛
らぶうしょうあく	羅封掌握
らぶすとーりー	物語
らほつ	螺髪
らみあ	蛇女神
らめい	裸名
ららら	蘭々羅
らん	濫
らんか	蘭花
らんぐいば	乱杭歯
らんしゅくそうしゅう	蘭叔宗秀
らんじゅばんほうていしき	ランジュバン方程式
らんそう	卵巣
らんたくあるごりずむ	乱択アルゴリズム
らんぶさんじゅうしょう	乱舞三重衝
らんぷ	洋灯
らんぷうたつまき	嵐風竜巻
らんほう	卵胞
らんほうくう	卵胞腔
らんほうまく	卵胞膜
らんぼう	乱妨
らんぼう	亂暴
らーすどらごん	暴竜
りある	現実的
りあん	莉杏
りいど	小歌
りえき	利益
りお	理央
りか	梨花
りかく	離角
りかけい	理科系
りかちん	李家鎮
りがい	利害
りがくぶ	理学部
りき	力
りく	陸
りくかん	六官
りくじょう	陸上
りくじょうきょうぎ	陸上競技
りくぶ	六部
りげん	俚言
りげーたーぶれーどましょういざよいぎり	リゲーターブレード魔性十六夜斬り
りこ	狸狐
りこくほう	李国方
りささい	神業祭
りざいろん	理財論
りざや	利鞘
りじちょう	理事長
りじょう	鯉城
りせい	里正
りそうきたい	理想気体
りそうすう	理想数
りそく	利足
りたん	李湛
りっか	律可
りっかりょうらん	六花繚乱
りっし	律師
りっそく	律速
りっぽう	立法
りっぽうすう	立方数
りつあん	立案
りつこく	立國
りつりん	栗林
りてつぎゅう	李鉄牛
りねん	亜麻
りびあ	利非亜
りふ	粒
りぶ	里部
りぶーと	再起動
りべら	搭乗者
りほ	理穂
りほう	理法
りほう	里房
りぼう	璃昴
りぽたんぱくしつ	リポタンパク質
りゃうのぎげ	令義解
りゃお	梁
りゃくおう	暦応
りやうぶん	領分
りやく	利益
りゅう	笠
りゅうおりがみ	龍折神
りゅうかかどみうむ	硫化カドミウム
りゅうかとう	柳華刀
りゅうき	竜騎
りゅうきし	竜騎士
りゅうげきけん	龍撃剣
りゅうげん	龍玄
りゅうこう	劉洽
りゅうこう	流光
りゅうこのげき	龍虎之戟
りゅうじんてっこうだん	龍神鉄鋼弾
りゅうず	竜頭
りゅうせい	彩青
りゅうせいおう	龍星王
りゅうせいかざぐるま	流星風車
りゅうせいきっく	龍星キック
りゅうせいげり	龍星蹴り
りゅうせいごう	流星号
りゅうせいしゅとう	龍星手刀
りゅうせいだん	流星弾
りゅうせいちょう	柳星張
りゅうせいつい	流星鎚
りゅうせいふうしゃげり	龍星風車蹴り
りゅうだい	琉大
りゅうてき	龍笛
りゅうでぃすく	龍ディスク
りゅうなんがくえん	龍南学園
りゅうのたつみ	龍野辰巳
りゅうのぼりきゃく	龍昇り脚
りゅうばくふ	龍瀑布
りゅうぶ	立部
りゅうぶ	竜部
りゅうほ	留保
りゅうめいおうさらまんです	龍冥王サラマンデス
りゅきあもじ	リュキア文字
りゆうさん	硫酸
りゆにおん	再契約
りょう	涼
りょうきはかせ	猟鬼博士
りょうしかがく	量子化学
りょうしかがくてきしゅほう	量子化学的手法
りょうしすう	量子数
りょうしりきがく	量子力学
りょうせん	領洗
りょうそうかん	凌霜館
りょうた	良太
りょうとく	亮徳
りょうべつ	了別
りょうもう	両毛
りょうりぢゃや	料理茶屋
りょかくれっしゃ	旅客列車
りょくおおざる	緑大猿
りょくぎょくずい	緑玉髄
りょくしょくけいこうたんぱくしつ	緑色蛍光タンパク質
りょくそうこう	緑藻綱
りょくは	緑波
りょくれい	緑麗
りょけん	旅券
りょこう	旅行
りょこうこぎって	旅行小切手
りょしゅう	虜囚
りょーすあーるゔ	光の妖精
りよう	利用
りようしよく	糧食
りようじよく	陵辱
りりす	璃々栖
りん	厘
りん	林
りん	鈴
りんかいほう	臨解放
りんき	臨気
りんきがいそう	臨気凱装
りんきほんりゅうごうてんへん	臨気奔流豪天変
りんぎのしょ	麟技の書
りんぐ	輪
りんけい	琳卿
りんげさ	輪袈裟
りんぞう	輪蔵
りんどうん	臨怒雲
りんらく	淪落
りんりん	玲玲
りゔぁいばー	死人返し
りー	李
りーふぉあ	麗華
るうぃご	ルウィ語
るおやん	洛陽
るしっどがじぇっと	武装明晰夢
るしふぁぽい	るしふぁぽい
るしふぁーぶれーど	堕天使光翼刃
るしふぇんりーと	魔王の凱歌
るどら	嶐鑼
るぱんさんせい	ルパン三世
るびー	紅宝石
るびー	紅玉
るふ	流布
るみ	留美
るり	瑠璃
るりおおかみ	瑠璃狼
るりこ	瑠璃子
るりひめ	瑠璃姫
るーくおぶじぇいど	翡翠の城将
るーたー	中継器
れい	例
れい	零
れい	靈
れい	黎
れいおん	霊音
れいか	れいか
れいか	麗花
れいがんどう	霊巌洞
れいき	励起
れいき	癘鬼
れいき	霊亀
れいけつがいしょうむかでりんがー	冷血鎧将ムカデリンガー
れいこ	玲子
れいこ	麗子
れいこうどう	黎紅堂
れいしょうでん	霊霄殿
れいしょうほうでん	霊霄宝殿
れいじゅう	霊獣
れいせんまち	冷泉町
れいぜんどおり	冷泉通り
れいたん	冷淡
れいな	麗奈
れいひ	麗燕
れいぴあ	細剣
れいふぉーす	閃光師団
れいめい	黎明
れいめいき	黎明期
れいめいのしとりじぇ	黎明の使徒リジェ
れいら	麗羅
れいりちゅう	伶俐虫
れいりょくらくらいは	霊力落雷波
れいれいちゅう	麗々虫
れいろう	玲瓏
れいわ	令和
れいわじだい	令和時代
れがとぅす	御剣者
れきし	歴史
れきじょ	歴女
れきぶ	鬲部
れぎおん	執行者
れくいえむ	鎮魂楽
れくいえむ	鎮魂歌
れぐなーれ	神域封剣
れじぇんず	英雄伝承
れじぇんど	物語
れっか	烈花
れっかくぎばっとー	烈火クギバットー
れっかげき	烈火撃
れっかしゅうげき	烈火蹴撃
れっかすい	裂罅水
れっさい	劣才
れっしゃ	列車
れっしゅうけん	烈蹴拳
れっすい	烈翠
れっとうし	烈闘士
れっとしょうこうぐん	レット症候群
れっどぞーんたいがーげき	レッドゾーンタイガー撃
れっどどらごんぞく	赤竜族
れつたか	烈鷹
れべりおん	天災姫
れむ	幻界
れめげとん	魔神隷従
れんきんじゅつ	恋禁術
れんけつりすと	連結リスト
れんげききょくせいけん	連撃極星拳
れんごくしゅんじん	煉獄隼迅
れんごくめっせん	煉獄滅殲
れんごくらいごう	煉獄雷剛
れんそう	斂葬
れんち	廉恥
れんぴ	連比
れんぽうちょっかつりょう	連邦直轄領
れんめん	連綿
れーるがん	超電磁砲
ろうあい	嫪毐
ろうえい	漏洩
ろうかん	琅玕
ろうき	狼鬼
ろうき	老奇
ろうしぐる	老師グル
ろうしゆう	陋習
ろうせい	老成
ろうせん	楼船
ろうそく	蝋燭
ろうちょうれんうん	籠鳥恋雲
ろうどうぶんぱいりつ	労働分配率
ろうにやくなんによ	老若男女
ろうにんがさ	浪人笠
ろうぶ	老部
ろうよ	老餘
ろうろうしゅう	狼狼蹴
ろおま	羅馬
ろくこんじき	六金色
ろくごうのもり	麓郷の森
ろくしゃきょうていしんぶんしゃようもじこーど	六社協定新聞社用文字コード
ろくじゅうぶんぽう	六十分法
ろくせ	六畝
ろくとうりょう	六凍梁
ろくのうしき	莨嚢式
ろくはいけ	緑波池
ろくぶ	鹿部
ろくや	録弥
ろくよう	六曜
ろくりきたいせん	鹿力大仙
ろけっと	弾丸
ろさりん	罗莎琳
ろざん	狼斬
ろしあせいきょうかい	ロシア正教会
ろしありんじせいふ	ロシア臨時政府
ろしょう	路昭
ろしょう	露昭
ろすとぜうむ	巨の黒槌
ろっかせん	六歌仙
ろっき	六輝
ろっく	六工
ろっくすみす	魔法鍵師
ろっこうしゃ	六工社
ろっこつげんしゅ	肋骨原種
ろっほ	湖
ろっぽんまつ	六本松
ろっぽんまつえき	六本松駅
ろでらこう	ロデラ綱
ろでらそうこう	ロデラ藻綱
ろに	羅尼
ろはん	小湖
ろばとでにろう	露鳩出似郎
ろびんそん	露壜村
ろぶ	鹵部
ろぶすたー	甲殻類
ろほう	濾胞
ろぼた	ロボ太
ろまんしえ	作家
ろん	論
ろんきふ	論及
ろんせつ	論説
ろんど	輪舞
ろんど	輪舞曲
ろんらい	龍來
ろんりねす	孤影
ろーましんわ	ローマ神話
ろーれるしすう	ローレル指数
ろーろー	儸儸
わい	和以
わいえるしゅとらすのよびていり	ワイエルシュトラスの予備定理
わいしょう	矮小
わいせつ	猥褻
わいゔぁーん	鋼尾翼竜
わか	壮
わか	若
わかくさかべのきみ	若日下部王
わかたらしひこのすめらみこと	若帯日子天皇
わかみや	若宮
わかやまでないと	和歌山県勲功爵
わかやまとねこひこおおびびのみこと	若倭根子日子大毘々命
わかやまとねこひこおほびびのみこと	若倭根子日子大毘毘命
わかれ	別
わが	我
わがく	和楽
わがしやゐん	我社員
わがちょう	我朝
わがにほん	我日本
わがはい	我輩
わがぶんめい	我文明
わがまま	我儘
わがもの	我物
わきがみ	掖上
わきじ	和喜次
わきま	弁
わきま	辨
わぎもこ	我妹子
わくせい	惑星
わけみずひこのかみ	別水彦神
わけみのじゅつ	分身之術
わげさ	輪袈裟
わこうぼく	和厚朴
わこく	倭国
わこのいけ	丸邇池
わこん	和魂
わごと	和事
わざ	工
わざにんしゅりけん	技忍シュリケン
わし	儂
わし	鷲
わしがさわ	鷲ヶ沢
わしずみひろし	鷲角博
わじま	輪島
わじん	倭人
わす	忘
わず	僅
わずか	僅
わせ	早稲
わた	度
わた	弥
わた	渉
わた	渡
わたぎ	綿木
わたくしほう	私法
わたくしりつ	私立
わたし	神獣
わたつみ	海若
わたつみのかみのみや	海神宮
わたなべどおり	渡辺通
わたらい	渡合
わたりすけべえ	渡スケ兵衛
わたりろうかはしりたい	渡り廊下走り隊
わたる	亘
わっかない	稚内
わで	和手
わどう	和銅
わな	罠
わにおとこ	鰐男
わにぐち	鰐口
わの	和野
わふつほうりつがっこう	和仏法律学校
わら	藁
わらはがみ	藁葉紙
わらべ	童
わらべうた	童歌
わるつ	円舞
わるびれず	無悪怯
わるふみ	悪文
われ	朕
われき	和暦
われもこう	地楡
われわれ	吾々
われわれ	我々
わんこざん	碗子山
わんさん	完山
わんたーんきる	一撃無双
わーすとえらー	極大誤算
わーどますたー	文字使い
ゐかせ	居稼
ゑび	海老
ゑびす	蛭子
ゑんぱう	遠方
をあさづまわくごのすくねのみこと	男淺津間若子宿禰命
をい	於
をか	岳
をか	陸
をきれ	尾切
をけのいはすわけのみこと	袁祁之石巣別命
をけのいわすわけのみこと	袁祁之石巣別命
をこた	怠
をごと	小琴
をさだ	他田
をさだのみや	他田宮
をさなご	幼児
をどひめ	袁努比売
をは	訖
をはりだ	小治田
をはりだのおほみや	小治田大宮
をばしのえ	小椅江
をほどのみこと	袁本柕命
をみなへし	女郎花
をよ	凡
をわりたのみや	小治田宮
をを	雄雄
ゔぁしれうす	召喚魔王
ゔぁなでぃーす	戦姫
ゔぁるきゅりあ	戦機乙女
ゔぁんぱいあ	吸血鬼
ゔぇらんだ	外廊
ゔぇんでった	報復殺人
